grid_lat,grid_lon,total_sample,mw_sample,mw_ratio,sub6_sample,sub6_ratio,5g_sample,5g_ratio,lte_sample,lte_ratio,total_cs_sample,mw_cs_sample,mw_cs_ratio,sub6_cs_sample,sub6_cs_ratio,5g_cs_sample,5g_cs_sample,lte_cs_sample,lte_cs_ratio
-86.1675,39.761,3010,0,0,179,0.059468439,179,0.059468439,2831,0.940531561,7,0,0,4,0.571428571,4,0.571428571,3,0.428571429
-86.1675,39.7655,387,0,0,387,1,387,1,0,0,2,0,0,2,1,2,1,0,0
-86.1675,39.774,231,0,0,215,0.930735931,215,0.930735931,16,0.069264069,7,0,0,6,0.857142857,6,0.857142857,1,0.142857143
-86.1675,39.778,714,0,0,672,0.941176471,672,0.941176471,42,0.058823529,24,0,0,20,0.833333333,20,0.833333333,4,0.166666667
-86.1675,39.7785,731,0,0,676,0.924760602,676,0.924760602,55,0.075239398,33,0,0,24,0.727272727,24,0.727272727,9,0.272727273
-86.1675,39.779,694,0,0,622,0.896253602,622,0.896253602,72,0.103746398,18,0,0,16,0.888888889,16,0.888888889,2,0.111111111
-86.1675,39.7795,642,0,0,601,0.936137072,601,0.936137072,41,0.063862928,24,0,0,18,0.75,18,0.75,6,0.25
-86.1675,39.78,650,0,0,548,0.843076923,548,0.843076923,102,0.156923077,26,0,0,15,0.576923077,15,0.576923077,11,0.423076923
-86.1675,39.7805,1189,0,0,370,0.31118587,370,0.31118587,819,0.68881413,45,0,0,18,0.4,18,0.4,27,0.6
-86.167,39.761,1531,0,0,555,0.362508165,555,0.362508165,976,0.637491835,30,0,0,13,0.433333333,13,0.433333333,17,0.566666667
-86.167,39.7615,8389,0,0,4674,0.557158183,4674,0.557158183,3715,0.442841817,46,0,0,21,0.456521739,21,0.456521739,25,0.543478261
-86.167,39.762,487,0,0,312,0.640657084,312,0.640657084,175,0.359342916,19,0,0,10,0.526315789,10,0.526315789,9,0.473684211
-86.167,39.7625,409,0,0,256,0.62591687,256,0.62591687,153,0.37408313,17,0,0,10,0.588235294,10,0.588235294,7,0.411764706
-86.167,39.763,385,0,0,212,0.550649351,212,0.550649351,173,0.449350649,18,0,0,9,0.5,9,0.5,9,0.5
-86.167,39.764,2956,0,0,1130,0.382273342,1130,0.382273342,1826,0.617726658,35,0,0,11,0.314285714,11,0.314285714,24,0.685714286
-86.167,39.765,913,0,0,803,0.879518072,803,0.879518072,110,0.120481928,23,0,0,12,0.52173913,12,0.52173913,11,0.47826087
-86.167,39.7655,1473,0,0,627,0.425661914,627,0.425661914,846,0.574338086,14,0,0,6,0.428571429,6,0.428571429,8,0.571428571
-86.167,39.766,1599,0,0,345,0.21575985,345,0.21575985,1254,0.78424015,22,0,0,6,0.272727273,6,0.272727273,16,0.727272727
-86.167,39.7665,429,0,0,219,0.51048951,219,0.51048951,210,0.48951049,8,0,0,4,0.5,4,0.5,4,0.5
-86.167,39.767,474,0,0,220,0.464135021,220,0.464135021,254,0.535864979,13,0,0,7,0.538461538,7,0.538461538,6,0.461538462
-86.167,39.7675,499,0,0,378,0.75751503,378,0.75751503,121,0.24248497,12,0,0,6,0.5,6,0.5,6,0.5
-86.167,39.768,181,0,0,0,0,0,0,181,1,5,0,0,0,0,0,0,5,1
-86.167,39.7685,118,0,0,0,0,0,0,118,1,3,0,0,0,0,0,0,3,1
-86.167,39.769,109,0,0,0,0,0,0,109,1,3,0,0,0,0,0,0,3,1
-86.167,39.7695,196,0,0,0,0,0,0,196,1,2,0,0,0,0,0,0,2,1
-86.167,39.77,328,0,0,0,0,0,0,328,1,5,0,0,0,0,0,0,5,1
-86.167,39.7705,190,0,0,0,0,0,0,190,1,4,0,0,0,0,0,0,4,1
-86.167,39.771,329,0,0,0,0,0,0,329,1,3,0,0,0,0,0,0,3,1
-86.167,39.7715,937,0,0,0,0,0,0,937,1,6,0,0,0,0,0,0,6,1
-86.167,39.772,159,0,0,0,0,0,0,159,1,6,0,0,0,0,0,0,6,1
-86.167,39.774,673,0,0,670,0.995542348,670,0.995542348,3,0.004457652,7,0,0,6,0.857142857,6,0.857142857,1,0.142857143
-86.167,39.776,83,0,0,83,1,83,1,0,0,3,0,0,3,1,3,1,0,0
-86.167,39.7765,397,0,0,397,1,397,1,0,0,11,0,0,11,1,11,1,0,0
-86.167,39.777,747,0,0,747,1,747,1,0,0,19,0,0,19,1,19,1,0,0
-86.167,39.7775,973,0,0,940,0.966084275,940,0.966084275,33,0.033915725,32,0,0,25,0.78125,25,0.78125,7,0.21875
-86.167,39.778,2267,0,0,2267,1,2267,1,0,0,13,0,0,13,1,13,1,0,0
-86.1665,39.761,89,0,0,89,1,89,1,0,0,1,0,0,1,1,1,1,0,0
-86.1665,39.7615,2461,0,0,1016,0.412840309,1016,0.412840309,1445,0.587159691,23,0,0,11,0.47826087,11,0.47826087,12,0.52173913
-86.1665,39.7635,435,0,0,177,0.406896552,177,0.406896552,258,0.593103448,17,0,0,8,0.470588235,8,0.470588235,9,0.529411765
-86.1665,39.765,174,0,0,174,1,174,1,0,0,1,0,0,1,1,1,1,0,0
-86.1665,39.7665,64,0,0,64,1,64,1,0,0,2,0,0,2,1,2,1,0,0
-86.1665,39.767,2552,0,0,1529,0.599137931,1529,0.599137931,1023,0.400862069,55,0,0,34,0.618181818,34,0.618181818,21,0.381818182
-86.1665,39.7675,765,0,0,627,0.819607843,627,0.819607843,138,0.180392157,30,0,0,18,0.6,18,0.6,12,0.4
-86.1665,39.768,1080,0,0,143,0.132407407,143,0.132407407,937,0.867592593,19,0,0,6,0.315789474,6,0.315789474,13,0.684210526
-86.1665,39.7685,829,0,0,112,0.135102533,112,0.135102533,717,0.864897467,14,0,0,3,0.214285714,3,0.214285714,11,0.785714286
-86.1665,39.769,839,0,0,95,0.113230036,95,0.113230036,744,0.886769964,36,0,0,4,0.111111111,4,0.111111111,32,0.888888889
-86.1665,39.7695,2245,0,0,334,0.148775056,334,0.148775056,1911,0.851224944,23,0,0,3,0.130434783,3,0.130434783,20,0.869565217
-86.1665,39.77,3456,0,0,80,0.023148148,80,0.023148148,3376,0.976851852,39,0,0,2,0.051282051,2,0.051282051,37,0.948717949
-86.1665,39.7705,1317,0,0,47,0.035687168,47,0.035687168,1270,0.964312832,28,0,0,1,0.035714286,1,0.035714286,27,0.964285714
-86.1665,39.771,4141,0,0,58,0.014006279,58,0.014006279,4083,0.985993721,19,0,0,1,0.052631579,1,0.052631579,18,0.947368421
-86.1665,39.7715,12841,0,0,316,0.024608675,316,0.024608675,12525,0.975391325,55,0,0,1,0.018181818,1,0.018181818,54,0.981818182
-86.1665,39.772,2479,0,0,28,0.011294877,28,0.011294877,2451,0.988705123,61,0,0,1,0.016393443,1,0.016393443,60,0.983606557
-86.1665,39.7725,3768,0,0,606,0.160828025,606,0.160828025,3162,0.839171975,100,0,0,21,0.21,21,0.21,79,0.79
-86.1665,39.773,4687,0,0,3523,0.75165351,3523,0.75165351,1164,0.24834649,97,0,0,44,0.453608247,44,0.453608247,53,0.546391753
-86.1665,39.7735,2485,0,0,2276,0.915895372,2276,0.915895372,209,0.084104628,78,0,0,51,0.653846154,51,0.653846154,27,0.346153846
-86.1665,39.774,8625,0,0,5359,0.621333333,5359,0.621333333,3266,0.378666667,67,0,0,48,0.71641791,48,0.71641791,19,0.28358209
-86.1665,39.7745,4067,0,0,4027,0.990164741,4027,0.990164741,40,0.009835259,28,0,0,24,0.857142857,24,0.857142857,4,0.142857143
-86.1665,39.775,3167,0,0,3134,0.989580044,3134,0.989580044,33,0.010419956,28,0,0,24,0.857142857,24,0.857142857,4,0.142857143
-86.1665,39.7755,2788,0,0,2077,0.744978479,2077,0.744978479,711,0.255021521,89,0,0,54,0.606741573,54,0.606741573,35,0.393258427
-86.1665,39.776,1297,0,0,1289,0.99383192,1289,0.99383192,8,0.00616808,23,0,0,21,0.913043478,21,0.913043478,2,0.086956522
-86.1665,39.7765,684,0,0,684,1,684,1,0,0,18,0,0,18,1,18,1,0,0
-86.1665,39.777,231,0,0,231,1,231,1,0,0,9,0,0,9,1,9,1,0,0
-86.1665,39.778,316,0,0,316,1,316,1,0,0,8,0,0,8,1,8,1,0,0
-86.166,39.7615,1017,0,0,339,0.333333333,339,0.333333333,678,0.666666667,15,0,0,7,0.466666667,7,0.466666667,8,0.533333333
-86.166,39.763,481,0,0,165,0.343035343,165,0.343035343,316,0.656964657,21,0,0,8,0.380952381,8,0.380952381,13,0.619047619
-86.166,39.767,1156,0,0,974,0.842560554,974,0.842560554,182,0.157439446,19,0,0,16,0.842105263,16,0.842105263,3,0.157894737
-86.166,39.77,855,0,0,193,0.225730994,193,0.225730994,662,0.774269006,51,0,0,14,0.274509804,14,0.274509804,37,0.725490196
-86.166,39.771,397,0,0,0,0,0,0,397,1,8,0,0,0,0,0,0,8,1
-86.166,39.7715,400,0,0,0,0,0,0,400,1,6,0,0,0,0,0,0,6,1
-86.166,39.774,5773,0,0,5345,0.92586177,5345,0.92586177,428,0.07413823,46,0,0,21,0.456521739,21,0.456521739,25,0.543478261
-86.166,39.775,148,0,0,144,0.972972973,144,0.972972973,4,0.027027027,3,0,0,2,0.666666667,2,0.666666667,1,0.333333333
-86.166,39.778,733,0,0,733,1,733,1,0,0,8,0,0,8,1,8,1,0,0
-86.1655,39.761,4246,0,0,723,0.170277909,723,0.170277909,3523,0.829722091,47,0,0,11,0.234042553,11,0.234042553,36,0.765957447
-86.1655,39.7615,2870,0,0,1597,0.556445993,1597,0.556445993,1273,0.443554007,41,0,0,17,0.414634146,17,0.414634146,24,0.585365854
-86.1655,39.762,535,0,0,241,0.45046729,241,0.45046729,294,0.54953271,13,0,0,7,0.538461538,7,0.538461538,6,0.461538462
-86.1655,39.7625,481,0,0,245,0.509355509,245,0.509355509,236,0.490644491,18,0,0,9,0.5,9,0.5,9,0.5
-86.1655,39.7655,293,0,0,37,0.126279863,37,0.126279863,256,0.873720137,11,0,0,2,0.181818182,2,0.181818182,9,0.818181818
-86.1655,39.767,668,0,0,516,0.77245509,516,0.77245509,152,0.22754491,14,0,0,12,0.857142857,12,0.857142857,2,0.142857143
-86.1655,39.77,747,0,0,423,0.56626506,423,0.56626506,324,0.43373494,35,0,0,17,0.485714286,17,0.485714286,18,0.514285714
-86.1655,39.771,417,0,0,0,0,0,0,417,1,8,0,0,0,0,0,0,8,1
-86.1655,39.7715,303,0,0,0,0,0,0,303,1,5,0,0,0,0,0,0,5,1
-86.1655,39.774,899,0,0,183,0.203559511,183,0.203559511,716,0.796440489,42,0,0,14,0.333333333,14,0.333333333,28,0.666666667
-86.1655,39.778,340,0,0,340,1,340,1,0,0,8,0,0,8,1,8,1,0,0
-86.165,39.761,204,0,0,0,0,0,0,204,1,1,0,0,0,0,0,0,1,1
-86.165,39.7615,2660,0,0,941,0.353759398,941,0.353759398,1719,0.646240602,24,0,0,10,0.416666667,10,0.416666667,14,0.583333333
-86.165,39.767,1874,0,0,1721,0.918356457,1721,0.918356457,153,0.081643543,22,0,0,19,0.863636364,19,0.863636364,3,0.136363636
-86.165,39.77,611,0,0,232,0.379705401,232,0.379705401,379,0.620294599,30,0,0,13,0.433333333,13,0.433333333,17,0.566666667
-86.165,39.771,511,0,0,5,0.009784736,5,0.009784736,506,0.990215264,36,0,0,1,0.027777778,1,0.027777778,35,0.972222222
-86.165,39.7715,225,0,0,0,0,0,0,225,1,10,0,0,0,0,0,0,10,1
-86.165,39.774,934,0,0,198,0.211991435,198,0.211991435,736,0.788008565,14,0,0,5,0.357142857,5,0.357142857,9,0.642857143
-86.165,39.7745,432,0,0,15,0.034722222,15,0.034722222,417,0.965277778,2,0,0,1,0.5,1,0.5,1,0.5
-86.165,39.778,329,0,0,329,1,329,1,0,0,8,0,0,8,1,8,1,0,0
-86.1645,39.7615,549,0,0,193,0.35154827,193,0.35154827,356,0.64845173,20,0,0,7,0.35,7,0.35,13,0.65
-86.1645,39.767,969,0,0,763,0.787409701,763,0.787409701,206,0.212590299,27,0,0,21,0.777777778,21,0.777777778,6,0.222222222
-86.1645,39.77,556,0,0,49,0.088129496,49,0.088129496,507,0.911870504,14,0,0,1,0.071428571,1,0.071428571,13,0.928571429
-86.1645,39.771,655,0,0,85,0.129770992,85,0.129770992,570,0.870229008,20,0,0,5,0.25,5,0.25,15,0.75
-86.1645,39.7715,123,0,0,0,0,0,0,123,1,6,0,0,0,0,0,0,6,1
-86.1645,39.774,4093,0,0,565,0.138040557,565,0.138040557,3528,0.861959443,14,0,0,4,0.285714286,4,0.285714286,10,0.714285714
-86.1645,39.778,342,0,0,342,1,342,1,0,0,8,0,0,8,1,8,1,0,0
-86.164,39.7615,511,0,0,124,0.242661448,124,0.242661448,387,0.757338552,16,0,0,2,0.125,2,0.125,14,0.875
-86.164,39.767,748,0,0,593,0.792780749,593,0.792780749,155,0.207219251,19,0,0,15,0.789473684,15,0.789473684,4,0.210526316
-86.164,39.7695,760,0,0,0,0,0,0,760,1,3,0,0,0,0,0,0,3,1
-86.164,39.77,656,0,0,46,0.070121951,46,0.070121951,610,0.929878049,19,0,0,2,0.105263158,2,0.105263158,17,0.894736842
-86.164,39.771,806,0,0,119,0.14764268,119,0.14764268,687,0.85235732,12,0,0,1,0.083333333,1,0.083333333,11,0.916666667
-86.164,39.7715,291,0,0,0,0,0,0,291,1,2,0,0,0,0,0,0,2,1
-86.164,39.774,1240,0,0,166,0.133870968,166,0.133870968,1074,0.866129032,15,0,0,5,0.333333333,5,0.333333333,10,0.666666667
-86.164,39.778,364,0,0,364,1,364,1,0,0,8,0,0,8,1,8,1,0,0
-86.1635,39.7615,503,0,0,126,0.250497018,126,0.250497018,377,0.749502982,21,0,0,5,0.238095238,5,0.238095238,16,0.761904762
-86.1635,39.767,842,0,0,653,0.775534442,653,0.775534442,189,0.224465558,34,0,0,24,0.705882353,24,0.705882353,10,0.294117647
-86.1635,39.7695,6503,0,0,357,0.05489774,357,0.05489774,6146,0.94510226,24,0,0,4,0.166666667,4,0.166666667,20,0.833333333
-86.1635,39.77,3615,0,0,429,0.118672199,429,0.118672199,3186,0.881327801,37,0,0,2,0.054054054,2,0.054054054,35,0.945945946
-86.1635,39.771,3086,0,0,400,0.129617628,400,0.129617628,2686,0.870382372,12,0,0,1,0.083333333,1,0.083333333,11,0.916666667
-86.1635,39.7715,224,0,0,186,0.830357143,186,0.830357143,38,0.169642857,3,0,0,1,0.333333333,1,0.333333333,2,0.666666667
-86.1635,39.774,797,0,0,171,0.21455458,171,0.21455458,626,0.78544542,13,0,0,5,0.384615385,5,0.384615385,8,0.615384615
-86.1635,39.778,976,0,0,976,1,976,1,0,0,10,0,0,10,1,10,1,0,0
-86.163,39.7615,2312,0,0,33,0.014273356,33,0.014273356,2279,0.985726644,20,0,0,3,0.15,3,0.15,17,0.85
-86.163,39.767,1947,0,0,1734,0.890600924,1734,0.890600924,213,0.109399076,40,0,0,25,0.625,25,0.625,15,0.375
-86.163,39.7675,278,0,0,274,0.985611511,274,0.985611511,4,0.014388489,3,0,0,2,0.666666667,2,0.666666667,1,0.333333333
-86.163,39.768,418,0,0,53,0.126794258,53,0.126794258,365,0.873205742,5,0,0,3,0.6,3,0.6,2,0.4
-86.163,39.7685,438,0,0,276,0.630136986,276,0.630136986,162,0.369863014,5,0,0,3,0.6,3,0.6,2,0.4
-86.163,39.769,447,0,0,446,0.997762864,446,0.997762864,1,0.002237136,2,0,0,1,0.5,1,0.5,1,0.5
-86.163,39.7695,2968,0,0,1506,0.507412399,1506,0.507412399,1462,0.492587601,29,0,0,11,0.379310345,11,0.379310345,18,0.620689655
-86.163,39.77,5758,0,0,288,0.050017367,288,0.050017367,5470,0.949982633,63,0,0,10,0.158730159,10,0.158730159,53,0.841269841
-86.163,39.7705,4644,0,0,104,0.022394488,104,0.022394488,4540,0.977605512,56,0,0,9,0.160714286,9,0.160714286,47,0.839285714
-86.163,39.771,7309,0,0,42,0.00574634,42,0.00574634,7267,0.99425366,51,0,0,3,0.058823529,3,0.058823529,48,0.941176471
-86.163,39.7715,9692,0,0,131,0.013516302,131,0.013516302,9561,0.986483698,28,0,0,4,0.142857143,4,0.142857143,24,0.857142857
-86.163,39.772,4362,0,0,0,0,0,0,4362,1,44,0,0,0,0,0,0,44,1
-86.163,39.7725,6693,0,0,407,0.060809801,407,0.060809801,6286,0.939190199,32,0,0,5,0.15625,5,0.15625,27,0.84375
-86.163,39.773,6022,0,0,34,0.005645965,34,0.005645965,5988,0.994354035,10,0,0,1,0.1,1,0.1,9,0.9
-86.163,39.7735,1731,0,0,129,0.074523397,129,0.074523397,1602,0.925476603,11,0,0,3,0.272727273,3,0.272727273,8,0.727272727
-86.163,39.774,3074,0,0,682,0.221860768,682,0.221860768,2392,0.778139232,42,0,0,18,0.428571429,18,0.428571429,24,0.571428571
-86.163,39.7745,1208,0,0,516,0.427152318,516,0.427152318,692,0.572847682,33,0,0,14,0.424242424,14,0.424242424,19,0.575757576
-86.163,39.775,3472,0,0,2107,0.606854839,2107,0.606854839,1365,0.393145161,35,0,0,17,0.485714286,17,0.485714286,18,0.514285714
-86.163,39.7755,3749,0,0,2661,0.709789277,2661,0.709789277,1088,0.290210723,58,0,0,33,0.568965517,33,0.568965517,25,0.431034483
-86.163,39.776,1312,0,0,1039,0.791920732,1039,0.791920732,273,0.208079268,29,0,0,20,0.689655172,20,0.689655172,9,0.310344828
-86.163,39.7765,1100,0,0,889,0.808181818,889,0.808181818,211,0.191818182,20,0,0,14,0.7,14,0.7,6,0.3
-86.163,39.777,1507,0,0,1185,0.786330458,1185,0.786330458,322,0.213669542,26,0,0,16,0.615384615,16,0.615384615,10,0.384615385
-86.163,39.7775,1082,0,0,981,0.906654344,981,0.906654344,101,0.093345656,22,0,0,15,0.681818182,15,0.681818182,7,0.318181818
-86.163,39.778,6338,0,0,6337,0.999842222,6337,0.999842222,1,0.000157778,17,0,0,16,0.941176471,16,0.941176471,1,0.058823529
-86.163,39.7785,399,0,0,399,1,399,1,0,0,5,0,0,5,1,5,1,0,0
-86.163,39.779,297,0,0,243,0.818181818,243,0.818181818,54,0.181818182,11,0,0,7,0.636363636,7,0.636363636,4,0.363636364
-86.163,39.7805,107,0,0,107,1,107,1,0,0,3,0,0,3,1,3,1,0,0
-86.1625,39.7615,516,0,0,2,0.003875969,2,0.003875969,514,0.996124031,15,0,0,1,0.066666667,1,0.066666667,14,0.933333333
-86.1625,39.767,968,0,0,757,0.782024793,757,0.782024793,211,0.217975207,55,0,0,31,0.563636364,31,0.563636364,24,0.436363636
-86.1625,39.7675,325,0,0,325,1,325,1,0,0,1,0,0,1,1,1,1,0,0
-86.1625,39.7695,1644,0,0,690,0.419708029,690,0.419708029,954,0.580291971,25,0,0,10,0.4,10,0.4,15,0.6
-86.1625,39.77,1143,0,0,418,0.365704287,418,0.365704287,725,0.634295713,60,0,0,19,0.316666667,19,0.316666667,41,0.683333333
-86.1625,39.771,2093,0,0,52,0.02484472,52,0.02484472,2041,0.97515528,20,0,0,4,0.2,4,0.2,16,0.8
-86.1625,39.7725,891,0,0,110,0.12345679,110,0.12345679,781,0.87654321,9,0,0,4,0.444444444,4,0.444444444,5,0.555555556
-86.1625,39.774,815,0,0,595,0.73006135,595,0.73006135,220,0.26993865,45,0,0,25,0.555555556,25,0.555555556,20,0.444444444
-86.1625,39.7755,469,0,0,451,0.961620469,451,0.961620469,18,0.038379531,16,0,0,12,0.75,12,0.75,4,0.25
-86.1625,39.778,942,0,0,941,0.998938429,941,0.998938429,1,0.001061571,8,0,0,7,0.875,7,0.875,1,0.125
-86.1625,39.7805,358,0,0,275,0.768156425,275,0.768156425,83,0.231843575,5,0,0,3,0.6,3,0.6,2,0.4
-86.162,39.761,768,0,0,0,0,0,0,768,1,3,0,0,0,0,0,0,3,1
-86.162,39.7615,901,0,0,12,0.013318535,12,0.013318535,889,0.986681465,13,0,0,1,0.076923077,1,0.076923077,12,0.923076923
-86.162,39.767,4351,0,0,4174,0.959319697,4174,0.959319697,177,0.040680303,37,0,0,24,0.648648649,24,0.648648649,13,0.351351351
-86.162,39.7675,318,0,0,294,0.924528302,294,0.924528302,24,0.075471698,4,0,0,2,0.5,2,0.5,2,0.5
-86.162,39.7695,1337,0,0,530,0.396409873,530,0.396409873,807,0.603590127,41,0,0,19,0.463414634,19,0.463414634,22,0.536585366
-86.162,39.77,843,0,0,383,0.454329775,383,0.454329775,460,0.545670225,48,0,0,19,0.395833333,19,0.395833333,29,0.604166667
-86.162,39.771,2748,0,0,1789,0.651018923,1789,0.651018923,959,0.348981077,95,0,0,35,0.368421053,35,0.368421053,60,0.631578947
-86.162,39.774,835,0,0,807,0.966467066,807,0.966467066,28,0.033532934,17,0,0,14,0.823529412,14,0.823529412,3,0.176470588
-86.162,39.7755,380,0,0,380,1,380,1,0,0,10,0,0,10,1,10,1,0,0
-86.162,39.778,446,0,0,405,0.908071749,405,0.908071749,41,0.091928251,7,0,0,6,0.857142857,6,0.857142857,1,0.142857143
-86.1615,39.761,1432,0,0,157,0.109636872,157,0.109636872,1275,0.890363128,21,0,0,4,0.19047619,4,0.19047619,17,0.80952381
-86.1615,39.7615,8253,0,0,1460,0.176905368,1460,0.176905368,6793,0.823094632,54,0,0,17,0.314814815,17,0.314814815,37,0.685185185
-86.1615,39.762,2209,0,0,1495,0.676776822,1495,0.676776822,714,0.323223178,40,0,0,24,0.6,24,0.6,16,0.4
-86.1615,39.7625,1083,0,0,1011,0.933518006,1011,0.933518006,72,0.066481994,23,0,0,20,0.869565217,20,0.869565217,3,0.130434783
-86.1615,39.763,955,0,0,783,0.819895288,783,0.819895288,172,0.180104712,45,0,0,33,0.733333333,33,0.733333333,12,0.266666667
-86.1615,39.7635,997,0,0,931,0.933801404,931,0.933801404,66,0.066198596,22,0,0,19,0.863636364,19,0.863636364,3,0.136363636
-86.1615,39.764,1205,0,0,1130,0.937759336,1130,0.937759336,75,0.062240664,28,0,0,23,0.821428571,23,0.821428571,5,0.178571429
-86.1615,39.7645,1438,0,0,1322,0.919332406,1322,0.919332406,116,0.080667594,47,0,0,35,0.744680851,35,0.744680851,12,0.255319149
-86.1615,39.765,1062,0,0,843,0.793785311,843,0.793785311,219,0.206214689,45,0,0,31,0.688888889,31,0.688888889,14,0.311111111
-86.1615,39.7655,2931,0,0,2542,0.867280792,2542,0.867280792,389,0.132719208,32,0,0,24,0.75,24,0.75,8,0.25
-86.1615,39.766,2739,0,0,2225,0.81234027,2225,0.81234027,514,0.18765973,36,0,0,26,0.722222222,26,0.722222222,10,0.277777778
-86.1615,39.7665,1765,0,0,1306,0.739943343,1306,0.739943343,459,0.260056657,66,0,0,40,0.606060606,40,0.606060606,26,0.393939394
-86.1615,39.767,5600,0,0,3118,0.556785714,3118,0.556785714,2482,0.443214286,96,0,0,44,0.458333333,44,0.458333333,52,0.541666667
-86.1615,39.7675,4785,0,0,983,0.205433647,983,0.205433647,3802,0.794566353,37,0,0,14,0.378378378,14,0.378378378,23,0.621621622
-86.1615,39.768,3550,0,0,452,0.127323944,452,0.127323944,3098,0.872676056,43,0,0,11,0.255813953,11,0.255813953,32,0.744186047
-86.1615,39.7685,4016,0,0,342,0.085159363,342,0.085159363,3674,0.914840637,35,0,0,7,0.2,7,0.2,28,0.8
-86.1615,39.769,4144,0,0,914,0.220559846,914,0.220559846,3230,0.779440154,35,0,0,4,0.114285714,4,0.114285714,31,0.885714286
-86.1615,39.7695,6510,0,0,630,0.096774194,630,0.096774194,5880,0.903225806,75,0,0,15,0.2,15,0.2,60,0.8
-86.1615,39.77,6256,0,0,685,0.109494885,685,0.109494885,5571,0.890505115,50,0,0,7,0.14,7,0.14,43,0.86
-86.1615,39.7705,3649,0,0,716,0.196218142,716,0.196218142,2933,0.803781858,49,0,0,17,0.346938776,17,0.346938776,32,0.653061224
-86.1615,39.771,6993,0,0,5488,0.784784785,5488,0.784784785,1505,0.215215215,92,0,0,54,0.586956522,54,0.586956522,38,0.413043478
-86.1615,39.7715,3585,0,0,1807,0.50404463,1807,0.50404463,1778,0.49595537,48,0,0,23,0.479166667,23,0.479166667,25,0.520833333
-86.1615,39.772,1531,0,0,506,0.330502939,506,0.330502939,1025,0.669497061,63,0,0,20,0.317460317,20,0.317460317,43,0.682539683
-86.1615,39.7725,3477,0,0,2216,0.637331032,2216,0.637331032,1261,0.362668968,48,0,0,18,0.375,18,0.375,30,0.625
-86.1615,39.773,865,0,0,435,0.502890173,435,0.502890173,430,0.497109827,25,0,0,14,0.56,14,0.56,11,0.44
-86.1615,39.774,965,0,0,663,0.687046632,663,0.687046632,302,0.312953368,95,0,0,54,0.568421053,54,0.568421053,41,0.431578947
-86.1615,39.7755,1110,0,0,1105,0.995495495,1105,0.995495495,5,0.004504505,12,0,0,11,0.916666667,11,0.916666667,1,0.083333333
-86.1615,39.778,749,0,0,718,0.958611482,718,0.958611482,31,0.041388518,11,0,0,8,0.727272727,8,0.727272727,3,0.272727273
-86.161,39.761,564,0,0,57,0.10106383,57,0.10106383,507,0.89893617,13,0,0,3,0.230769231,3,0.230769231,10,0.769230769
-86.161,39.7615,1799,0,0,94,0.052251251,94,0.052251251,1705,0.947748749,41,0,0,3,0.073170732,3,0.073170732,38,0.926829268
-86.161,39.7655,6047,0,0,883,0.146022821,883,0.146022821,5164,0.853977179,28,0,0,12,0.428571429,12,0.428571429,16,0.571428571
-86.161,39.767,3998,0,0,3816,0.954477239,3816,0.954477239,182,0.045522761,36,0,0,28,0.777777778,28,0.777777778,8,0.222222222
-86.161,39.7685,63,0,0,0,0,0,0,63,1,1,0,0,0,0,0,0,1,1
-86.161,39.769,388,0,0,0,0,0,0,388,1,2,0,0,0,0,0,0,2,1
-86.161,39.7695,7824,0,0,130,0.016615542,130,0.016615542,7694,0.983384458,47,0,0,5,0.106382979,5,0.106382979,42,0.893617021
-86.161,39.77,5061,0,0,137,0.027069749,137,0.027069749,4924,0.972930251,42,0,0,6,0.142857143,6,0.142857143,36,0.857142857
-86.161,39.7705,1347,0,0,187,0.138827023,187,0.138827023,1160,0.861172977,18,0,0,1,0.055555556,1,0.055555556,17,0.944444444
-86.161,39.771,2824,0,0,2180,0.771954674,2180,0.771954674,644,0.228045326,61,0,0,33,0.540983607,33,0.540983607,28,0.459016393
-86.161,39.772,358,0,0,59,0.164804469,59,0.164804469,299,0.835195531,20,0,0,7,0.35,7,0.35,13,0.65
-86.161,39.7725,1902,0,0,899,0.472660358,899,0.472660358,1003,0.527339642,45,0,0,18,0.4,18,0.4,27,0.6
-86.161,39.773,928,0,0,366,0.394396552,366,0.394396552,562,0.605603448,21,0,0,12,0.571428571,12,0.571428571,9,0.428571429
-86.161,39.7735,1196,0,0,559,0.467391304,559,0.467391304,637,0.532608696,29,0,0,17,0.586206897,17,0.586206897,12,0.413793103
-86.161,39.774,7283,0,0,5550,0.762048606,5550,0.762048606,1733,0.237951394,82,0,0,50,0.609756098,50,0.609756098,32,0.390243902
-86.161,39.7745,1670,0,0,944,0.565269461,944,0.565269461,726,0.434730539,28,0,0,17,0.607142857,17,0.607142857,11,0.392857143
-86.161,39.775,1110,0,0,788,0.70990991,788,0.70990991,322,0.29009009,31,0,0,19,0.612903226,19,0.612903226,12,0.387096774
-86.161,39.7755,4161,0,0,3789,0.910598414,3789,0.910598414,372,0.089401586,35,0,0,25,0.714285714,25,0.714285714,10,0.285714286
-86.161,39.776,539,0,0,438,0.812615955,438,0.812615955,101,0.187384045,11,0,0,8,0.727272727,8,0.727272727,3,0.272727273
-86.161,39.7765,2070,0,0,1400,0.676328502,1400,0.676328502,670,0.323671498,9,0,0,7,0.777777778,7,0.777777778,2,0.222222222
-86.161,39.777,1264,0,0,789,0.624208861,789,0.624208861,475,0.375791139,13,0,0,9,0.692307692,9,0.692307692,4,0.307692308
-86.161,39.7775,625,0,0,409,0.6544,409,0.6544,216,0.3456,21,0,0,13,0.619047619,13,0.619047619,8,0.380952381
-86.161,39.778,4523,0,0,3620,0.800353748,3620,0.800353748,903,0.199646252,40,0,0,23,0.575,23,0.575,17,0.425
-86.161,39.7785,210,0,0,197,0.938095238,197,0.938095238,13,0.061904762,7,0,0,5,0.714285714,5,0.714285714,2,0.285714286
-86.161,39.779,215,0,0,208,0.96744186,208,0.96744186,7,0.03255814,6,0,0,5,0.833333333,5,0.833333333,1,0.166666667
-86.161,39.7795,187,0,0,187,1,187,1,0,0,4,0,0,4,1,4,1,0,0
-86.161,39.78,173,0,0,173,1,173,1,0,0,4,0,0,4,1,4,1,0,0
-86.161,39.7805,291,0,0,291,1,291,1,0,0,4,0,0,4,1,4,1,0,0
-86.1605,39.761,500,0,0,43,0.086,43,0.086,457,0.914,20,0,0,1,0.05,1,0.05,19,0.95
-86.1605,39.7615,1436,0,0,90,0.062674095,90,0.062674095,1346,0.937325905,44,0,0,3,0.068181818,3,0.068181818,41,0.931818182
-86.1605,39.7655,541,0,0,320,0.591497227,320,0.591497227,221,0.408502773,8,0,0,7,0.875,7,0.875,1,0.125
-86.1605,39.767,1625,0,0,1435,0.883076923,1435,0.883076923,190,0.116923077,33,0,0,25,0.757575758,25,0.757575758,8,0.242424242
-86.1605,39.7685,260,0,0,260,1,260,1,0,0,1,0,0,1,1,1,1,0,0
-86.1605,39.7695,2503,0,0,248,0.099081103,248,0.099081103,2255,0.900918897,53,0,0,8,0.150943396,8,0.150943396,45,0.849056604
-86.1605,39.77,1430,0,0,518,0.362237762,518,0.362237762,912,0.637762238,22,0,0,6,0.272727273,6,0.272727273,16,0.727272727
-86.1605,39.771,2907,0,0,733,0.252149983,733,0.252149983,2174,0.747850017,62,0,0,24,0.387096774,24,0.387096774,38,0.612903226
-86.1605,39.7725,572,0,0,446,0.77972028,446,0.77972028,126,0.22027972,13,0,0,9,0.692307692,9,0.692307692,4,0.307692308
-86.1605,39.774,1079,0,0,1006,0.932344764,1006,0.932344764,73,0.067655236,48,0,0,37,0.770833333,37,0.770833333,11,0.229166667
-86.1605,39.7755,1268,0,0,1145,0.902996845,1145,0.902996845,123,0.097003155,18,0,0,16,0.888888889,16,0.888888889,2,0.111111111
-86.1605,39.778,1121,0,0,939,0.83764496,939,0.83764496,182,0.16235504,22,0,0,13,0.590909091,13,0.590909091,9,0.409090909
-86.16,39.761,6602,0,0,427,0.06467737,427,0.06467737,6175,0.93532263,51,0,0,10,0.196078431,10,0.196078431,41,0.803921569
-86.16,39.7615,4096,0,0,381,0.093017578,381,0.093017578,3715,0.906982422,37,0,0,2,0.054054054,2,0.054054054,35,0.945945946
-86.16,39.762,1070,0,0,193,0.180373832,193,0.180373832,877,0.819626168,47,0,0,10,0.212765957,10,0.212765957,37,0.787234043
-86.16,39.7625,4423,0,0,3827,0.86524983,3827,0.86524983,596,0.13475017,24,0,0,15,0.625,15,0.625,9,0.375
-86.16,39.763,1838,0,0,1542,0.838955386,1542,0.838955386,296,0.161044614,17,0,0,12,0.705882353,12,0.705882353,5,0.294117647
-86.16,39.7635,1120,0,0,888,0.792857143,888,0.792857143,232,0.207142857,43,0,0,24,0.558139535,24,0.558139535,19,0.441860465
-86.16,39.764,1680,0,0,1638,0.975,1638,0.975,42,0.025,22,0,0,15,0.681818182,15,0.681818182,7,0.318181818
-86.16,39.7645,613,0,0,584,0.95269168,584,0.95269168,29,0.04730832,10,0,0,8,0.8,8,0.8,2,0.2
-86.16,39.765,917,0,0,832,0.907306434,832,0.907306434,85,0.092693566,39,0,0,29,0.743589744,29,0.743589744,10,0.256410256
-86.16,39.7655,3082,0,0,1646,0.534068787,1646,0.534068787,1436,0.465931213,30,0,0,22,0.733333333,22,0.733333333,8,0.266666667
-86.16,39.766,1350,0,0,1346,0.997037037,1346,0.997037037,4,0.002962963,7,0,0,6,0.857142857,6,0.857142857,1,0.142857143
-86.16,39.7665,1830,0,0,1563,0.854098361,1563,0.854098361,267,0.145901639,29,0,0,20,0.689655172,20,0.689655172,9,0.310344828
-86.16,39.767,4833,0,0,4554,0.942271881,4554,0.942271881,279,0.057728119,66,0,0,46,0.696969697,46,0.696969697,20,0.303030303
-86.16,39.7675,1485,0,0,1237,0.832996633,1237,0.832996633,248,0.167003367,17,0,0,13,0.764705882,13,0.764705882,4,0.235294118
-86.16,39.768,2643,0,0,2513,0.95081347,2513,0.95081347,130,0.04918653,20,0,0,15,0.75,15,0.75,5,0.25
-86.16,39.7685,1354,0,0,1233,0.910635155,1233,0.910635155,121,0.089364845,15,0,0,12,0.8,12,0.8,3,0.2
-86.16,39.769,473,0,0,349,0.737843552,349,0.737843552,124,0.262156448,13,0,0,8,0.615384615,8,0.615384615,5,0.384615385
-86.16,39.7695,7401,0,0,5765,0.778948791,5765,0.778948791,1636,0.221051209,57,0,0,28,0.49122807,28,0.49122807,29,0.50877193
-86.16,39.77,2896,0,0,1821,0.628798343,1821,0.628798343,1075,0.371201657,34,0,0,16,0.470588235,16,0.470588235,18,0.529411765
-86.16,39.7705,59,0,0,59,1,59,1,0,0,2,0,0,2,1,2,1,0,0
-86.16,39.771,2506,0,0,192,0.076616121,192,0.076616121,2314,0.923383879,62,0,0,11,0.177419355,11,0.177419355,51,0.822580645
-86.16,39.7725,4344,0,0,4294,0.988489871,4294,0.988489871,50,0.011510129,13,0,0,10,0.769230769,10,0.769230769,3,0.230769231
-86.16,39.774,1029,0,0,1013,0.984450923,1013,0.984450923,16,0.015549077,26,0,0,21,0.807692308,21,0.807692308,5,0.192307692
-86.16,39.7755,739,0,0,644,0.871447903,644,0.871447903,95,0.128552097,21,0,0,17,0.80952381,17,0.80952381,4,0.19047619
-86.16,39.7775,72,0,0,69,0.958333333,69,0.958333333,3,0.041666667,3,0,0,2,0.666666667,2,0.666666667,1,0.333333333
-86.16,39.778,495,0,0,383,0.773737374,383,0.773737374,112,0.226262626,18,0,0,11,0.611111111,11,0.611111111,7,0.388888889
-86.1595,39.761,261,0,0,0,0,0,0,261,1,7,0,0,0,0,0,0,7,1
-86.1595,39.7615,1856,0,0,0,0,0,0,1856,1,6,0,0,0,0,0,0,6,1
-86.1595,39.764,390,0,0,349,0.894871795,349,0.894871795,41,0.105128205,9,0,0,8,0.888888889,8,0.888888889,1,0.111111111
-86.1595,39.7645,420,0,0,377,0.897619048,377,0.897619048,43,0.102380952,7,0,0,6,0.857142857,6,0.857142857,1,0.142857143
-86.1595,39.765,1428,0,0,1339,0.93767507,1339,0.93767507,89,0.06232493,33,0,0,22,0.666666667,22,0.666666667,11,0.333333333
-86.1595,39.7655,1266,0,0,953,0.752764613,953,0.752764613,313,0.247235387,23,0,0,19,0.826086957,19,0.826086957,4,0.173913043
-86.1595,39.766,1314,0,0,1196,0.910197869,1196,0.910197869,118,0.089802131,16,0,0,13,0.8125,13,0.8125,3,0.1875
-86.1595,39.7665,4836,0,0,4368,0.903225806,4368,0.903225806,468,0.096774194,95,0,0,60,0.631578947,60,0.631578947,35,0.368421053
-86.1595,39.767,13407,0,0,12293,0.916909077,12293,0.916909077,1114,0.083090923,303,0,0,202,0.666666667,202,0.666666667,101,0.333333333
-86.1595,39.7675,14410,0,0,13690,0.950034698,13690,0.950034698,720,0.049965302,161,0,0,107,0.664596273,107,0.664596273,54,0.335403727
-86.1595,39.768,17583,0,0,16530,0.940112609,16530,0.940112609,1053,0.059887391,190,0,0,115,0.605263158,115,0.605263158,75,0.394736842
-86.1595,39.7685,9767,0,0,9049,0.926487151,9049,0.926487151,718,0.073512849,91,0,0,67,0.736263736,67,0.736263736,24,0.263736264
-86.1595,39.769,9906,0,0,8910,0.899454876,8910,0.899454876,996,0.100545124,187,0,0,113,0.604278075,113,0.604278075,74,0.395721925
-86.1595,39.7695,20149,0,0,18295,0.907985508,18295,0.907985508,1854,0.092014492,141,0,0,92,0.65248227,92,0.65248227,49,0.34751773
-86.1595,39.77,8835,0,0,6620,0.749292586,6620,0.749292586,2215,0.250707414,134,0,0,80,0.597014925,80,0.597014925,54,0.402985075
-86.1595,39.7705,9022,0,0,6135,0.680004434,6135,0.680004434,2887,0.319995566,122,0,0,65,0.532786885,65,0.532786885,57,0.467213115
-86.1595,39.771,8640,0,0,2612,0.302314815,2612,0.302314815,6028,0.697685185,57,0,0,20,0.350877193,20,0.350877193,37,0.649122807
-86.1595,39.7715,2612,0,0,395,0.151225115,395,0.151225115,2217,0.848774885,37,0,0,11,0.297297297,11,0.297297297,26,0.702702703
-86.1595,39.772,2747,0,0,1145,0.416818347,1145,0.416818347,1602,0.583181653,66,0,0,26,0.393939394,26,0.393939394,40,0.606060606
-86.1595,39.7725,3536,0,0,2931,0.828902715,2931,0.828902715,605,0.171097285,45,0,0,27,0.6,27,0.6,18,0.4
-86.1595,39.773,1391,0,0,1071,0.769949676,1071,0.769949676,320,0.230050324,23,0,0,14,0.608695652,14,0.608695652,9,0.391304348
-86.1595,39.7735,1364,0,0,1026,0.752199413,1026,0.752199413,338,0.247800587,21,0,0,14,0.666666667,14,0.666666667,7,0.333333333
-86.1595,39.774,2672,0,0,2356,0.881736527,2356,0.881736527,316,0.118263473,37,0,0,27,0.72972973,27,0.72972973,10,0.27027027
-86.1595,39.7745,1648,0,0,1301,0.789441748,1301,0.789441748,347,0.210558252,18,0,0,12,0.666666667,12,0.666666667,6,0.333333333
-86.1595,39.775,2628,0,0,2149,0.817732116,2149,0.817732116,479,0.182267884,43,0,0,22,0.511627907,22,0.511627907,21,0.488372093
-86.1595,39.7755,2998,0,0,2705,0.902268179,2705,0.902268179,293,0.097731821,79,0,0,48,0.607594937,48,0.607594937,31,0.392405063
-86.1595,39.776,3134,0,0,2648,0.844926611,2648,0.844926611,486,0.155073389,21,0,0,12,0.571428571,12,0.571428571,9,0.428571429
-86.1595,39.7765,1386,0,0,1254,0.904761905,1254,0.904761905,132,0.095238095,14,0,0,8,0.571428571,8,0.571428571,6,0.428571429
-86.1595,39.777,387,0,0,298,0.77002584,298,0.77002584,89,0.22997416,10,0,0,7,0.7,7,0.7,3,0.3
-86.1595,39.7775,378,0,0,299,0.791005291,299,0.791005291,79,0.208994709,8,0,0,4,0.5,4,0.5,4,0.5
-86.1595,39.778,2437,0,0,2239,0.918752565,2239,0.918752565,198,0.081247435,22,0,0,13,0.590909091,13,0.590909091,9,0.409090909
-86.159,39.761,242,0,0,0,0,0,0,242,1,7,0,0,0,0,0,0,7,1
-86.159,39.7615,146,0,0,0,0,0,0,146,1,5,0,0,0,0,0,0,5,1
-86.159,39.7665,182,0,0,182,1,182,1,0,0,4,0,0,4,1,4,1,0,0
-86.159,39.767,7093,0,0,6591,0.929225997,6591,0.929225997,502,0.070774003,86,0,0,62,0.720930233,62,0.720930233,24,0.279069767
-86.159,39.7675,426,0,0,308,0.723004695,308,0.723004695,118,0.276995305,9,0,0,6,0.666666667,6,0.666666667,3,0.333333333
-86.159,39.7685,340,0,0,330,0.970588235,330,0.970588235,10,0.029411765,8,0,0,6,0.75,6,0.75,2,0.25
-86.159,39.7695,4119,0,0,3515,0.853362467,3515,0.853362467,604,0.146637533,118,0,0,71,0.601694915,71,0.601694915,47,0.398305085
-86.159,39.77,3120,0,0,1978,0.633974359,1978,0.633974359,1142,0.366025641,96,0,0,39,0.40625,39,0.40625,57,0.59375
-86.159,39.771,1247,0,0,79,0.063352045,79,0.063352045,1168,0.936647955,19,0,0,4,0.210526316,4,0.210526316,15,0.789473684
-86.159,39.7725,604,0,0,552,0.913907285,552,0.913907285,52,0.086092715,6,0,0,4,0.666666667,4,0.666666667,2,0.333333333
-86.159,39.774,1452,0,0,1298,0.893939394,1298,0.893939394,154,0.106060606,34,0,0,19,0.558823529,19,0.558823529,15,0.441176471
-86.159,39.775,298,0,0,272,0.912751678,272,0.912751678,26,0.087248322,4,0,0,2,0.5,2,0.5,2,0.5
-86.159,39.7755,543,0,0,435,0.801104972,435,0.801104972,108,0.198895028,24,0,0,15,0.625,15,0.625,9,0.375
-86.159,39.7765,574,0,0,507,0.883275261,507,0.883275261,67,0.116724739,9,0,0,6,0.666666667,6,0.666666667,3,0.333333333
-86.159,39.777,363,0,0,250,0.688705234,250,0.688705234,113,0.311294766,8,0,0,5,0.625,5,0.625,3,0.375
-86.159,39.7775,649,0,0,418,0.644067797,418,0.644067797,231,0.355932203,24,0,0,12,0.5,12,0.5,12,0.5
-86.159,39.778,1288,0,0,1145,0.888975155,1145,0.888975155,143,0.111024845,25,0,0,16,0.64,16,0.64,9,0.36
-86.159,39.7795,188,0,0,181,0.962765957,181,0.962765957,7,0.037234043,6,0,0,4,0.666666667,4,0.666666667,2,0.333333333
-86.159,39.78,192,0,0,192,1,192,1,0,0,4,0,0,4,1,4,1,0,0
-86.159,39.7805,263,0,0,263,1,263,1,0,0,4,0,0,4,1,4,1,0,0
-86.1585,39.761,1038,0,0,0,0,0,0,1038,1,14,0,0,0,0,0,0,14,1
-86.1585,39.7615,90,0,0,0,0,0,0,90,1,3,0,0,0,0,0,0,3,1
-86.1585,39.7655,630,0,0,245,0.388888889,245,0.388888889,385,0.611111111,20,0,0,10,0.5,10,0.5,10,0.5
-86.1585,39.7665,315,0,0,315,1,315,1,0,0,6,0,0,6,1,6,1,0,0
-86.1585,39.767,4555,0,0,4465,0.980241493,4465,0.980241493,90,0.019758507,49,0,0,39,0.795918367,39,0.795918367,10,0.204081633
-86.1585,39.768,26205,0,0,25112,0.958290403,25112,0.958290403,1093,0.041709597,60,0,0,42,0.7,42,0.7,18,0.3
-86.1585,39.7685,29772,0,0,3280,0.11017063,3280,0.11017063,26492,0.88982937,61,0,0,47,0.770491803,47,0.770491803,14,0.229508197
-86.1585,39.769,175,0,0,171,0.977142857,171,0.977142857,4,0.022857143,7,0,0,6,0.857142857,6,0.857142857,1,0.142857143
-86.1585,39.7695,3290,0,0,2233,0.678723404,2233,0.678723404,1057,0.321276596,134,0,0,68,0.507462687,68,0.507462687,66,0.492537313
-86.1585,39.77,1846,0,0,1249,0.67659805,1249,0.67659805,597,0.32340195,50,0,0,24,0.48,24,0.48,26,0.52
-86.1585,39.771,2175,0,0,104,0.047816092,104,0.047816092,2071,0.952183908,54,0,0,5,0.092592593,5,0.092592593,49,0.907407407
-86.1585,39.7725,234,0,0,205,0.876068376,205,0.876068376,29,0.123931624,10,0,0,5,0.5,5,0.5,5,0.5
-86.1585,39.774,899,0,0,262,0.291434928,262,0.291434928,637,0.708565072,55,0,0,17,0.309090909,17,0.309090909,38,0.690909091
-86.1585,39.7755,437,0,0,400,0.915331808,400,0.915331808,37,0.084668192,16,0,0,13,0.8125,13,0.8125,3,0.1875
-86.1585,39.7775,96,0,0,91,0.947916667,91,0.947916667,5,0.052083333,6,0,0,5,0.833333333,5,0.833333333,1,0.166666667
-86.1585,39.778,367,0,0,268,0.730245232,268,0.730245232,99,0.269754768,23,0,0,15,0.652173913,15,0.652173913,8,0.347826087
-86.158,39.761,4068,0,0,367,0.090216323,367,0.090216323,3701,0.909783677,33,0,0,7,0.212121212,7,0.212121212,26,0.787878788
-86.158,39.7615,1403,0,0,51,0.036350677,51,0.036350677,1352,0.963649323,30,0,0,6,0.2,6,0.2,24,0.8
-86.158,39.762,1062,0,0,16,0.015065913,16,0.015065913,1046,0.984934087,31,0,0,2,0.064516129,2,0.064516129,29,0.935483871
-86.158,39.7625,1900,0,0,51,0.026842105,51,0.026842105,1849,0.973157895,27,0,0,1,0.037037037,1,0.037037037,26,0.962962963
-86.158,39.763,3425,0,0,181,0.052846715,181,0.052846715,3244,0.947153285,31,0,0,7,0.225806452,7,0.225806452,24,0.774193548
-86.158,39.7635,2467,0,0,1221,0.494933117,1221,0.494933117,1246,0.505066883,54,0,0,23,0.425925926,23,0.425925926,31,0.574074074
-86.158,39.764,3035,0,0,2535,0.835255354,2535,0.835255354,500,0.164744646,75,0,0,40,0.533333333,40,0.533333333,35,0.466666667
-86.158,39.7645,1438,0,0,1007,0.700278164,1007,0.700278164,431,0.299721836,51,0,0,30,0.588235294,30,0.588235294,21,0.411764706
-86.158,39.765,1461,0,0,868,0.594113621,868,0.594113621,593,0.405886379,41,0,0,24,0.585365854,24,0.585365854,17,0.414634146
-86.158,39.7655,3125,0,0,1875,0.6,1875,0.6,1250,0.4,67,0,0,40,0.597014925,40,0.597014925,27,0.402985075
-86.158,39.766,2352,0,0,1820,0.773809524,1820,0.773809524,532,0.226190476,36,0,0,27,0.75,27,0.75,9,0.25
-86.158,39.7665,3262,0,0,2970,0.910484365,2970,0.910484365,292,0.089515635,41,0,0,32,0.780487805,32,0.780487805,9,0.219512195
-86.158,39.767,15008,0,0,12938,0.862073561,12938,0.862073561,2070,0.137926439,140,0,0,100,0.714285714,100,0.714285714,40,0.285714286
-86.158,39.7675,7059,0,0,5991,0.848703782,5991,0.848703782,1068,0.151296218,103,0,0,71,0.689320388,71,0.689320388,32,0.310679612
-86.158,39.768,2708,0,0,2551,0.942023634,2551,0.942023634,157,0.057976366,31,0,0,24,0.774193548,24,0.774193548,7,0.225806452
-86.158,39.7685,1173,0,0,964,0.821824382,964,0.821824382,209,0.178175618,32,0,0,24,0.75,24,0.75,8,0.25
-86.158,39.769,5300,0,0,4373,0.82509434,4373,0.82509434,927,0.17490566,76,0,0,53,0.697368421,53,0.697368421,23,0.302631579
-86.158,39.7695,11859,0,0,9030,0.761447002,9030,0.761447002,2829,0.238552998,142,0,0,80,0.563380282,80,0.563380282,62,0.436619718
-86.158,39.77,3818,0,0,1252,0.327920377,1252,0.327920377,2566,0.672079623,41,0,0,23,0.56097561,23,0.56097561,18,0.43902439
-86.158,39.7705,498,0,0,179,0.359437751,179,0.359437751,319,0.640562249,22,0,0,7,0.318181818,7,0.318181818,15,0.681818182
-86.158,39.771,2941,0,0,284,0.096565794,284,0.096565794,2657,0.903434206,28,0,0,7,0.25,7,0.25,21,0.75
-86.158,39.7725,3082,0,0,2682,0.870214147,2682,0.870214147,400,0.129785853,12,0,0,6,0.5,6,0.5,6,0.5
-86.158,39.774,931,0,0,103,0.110633727,103,0.110633727,828,0.889366273,26,0,0,4,0.153846154,4,0.153846154,22,0.846153846
-86.158,39.775,587,0,0,335,0.570698467,335,0.570698467,252,0.429301533,4,0,0,3,0.75,3,0.75,1,0.25
-86.158,39.7755,509,0,0,458,0.899803536,458,0.899803536,51,0.100196464,17,0,0,14,0.823529412,14,0.823529412,3,0.176470588
-86.158,39.7775,140,0,0,138,0.985714286,138,0.985714286,2,0.014285714,3,0,0,3,1,3,1,0,0
-86.158,39.778,349,0,0,264,0.756446991,264,0.756446991,85,0.243553009,8,0,0,7,0.875,7,0.875,1,0.125
-86.1575,39.761,923,0,0,125,0.135427952,125,0.135427952,798,0.864572048,25,0,0,3,0.12,3,0.12,22,0.88
-86.1575,39.7615,168,0,0,0,0,0,0,168,1,4,0,0,0,0,0,0,4,1
-86.1575,39.7655,580,0,0,471,0.812068966,471,0.812068966,109,0.187931034,13,0,0,8,0.615384615,8,0.615384615,5,0.384615385
-86.1575,39.7665,1308,0,0,1308,1,1308,1,0,0,11,0,0,11,1,11,1,0,0
-86.1575,39.767,14981,0,0,14748,0.984446966,14748,0.984446966,233,0.015553034,103,0,0,80,0.776699029,80,0.776699029,23,0.223300971
-86.1575,39.7675,17595,0,0,17216,0.97845979,17216,0.97845979,379,0.02154021,75,0,0,49,0.653333333,49,0.653333333,26,0.346666667
-86.1575,39.768,2572,0,0,2332,0.906687403,2332,0.906687403,240,0.093312597,55,0,0,40,0.727272727,40,0.727272727,15,0.272727273
-86.1575,39.7685,1530,0,0,1429,0.933986928,1429,0.933986928,101,0.066013072,40,0,0,33,0.825,33,0.825,7,0.175
-86.1575,39.769,7627,0,0,6639,0.870460207,6639,0.870460207,988,0.129539793,107,0,0,70,0.654205607,70,0.654205607,37,0.345794393
-86.1575,39.7695,9203,0,0,6235,0.677496469,6235,0.677496469,2968,0.322503531,152,0,0,92,0.605263158,92,0.605263158,60,0.394736842
-86.1575,39.77,1731,0,0,1361,0.786250722,1361,0.786250722,370,0.213749278,24,0,0,18,0.75,18,0.75,6,0.25
-86.1575,39.7705,1094,0,0,264,0.241316271,264,0.241316271,830,0.758683729,36,0,0,13,0.361111111,13,0.361111111,23,0.638888889
-86.1575,39.771,4300,0,0,726,0.168837209,726,0.168837209,3574,0.831162791,49,0,0,12,0.244897959,12,0.244897959,37,0.755102041
-86.1575,39.7715,2820,0,0,385,0.136524823,385,0.136524823,2435,0.863475177,28,0,0,5,0.178571429,5,0.178571429,23,0.821428571
-86.1575,39.772,1219,0,0,244,0.200164069,244,0.200164069,975,0.799835931,42,0,0,9,0.214285714,9,0.214285714,33,0.785714286
-86.1575,39.7725,1512,0,0,171,0.113095238,171,0.113095238,1341,0.886904762,25,0,0,5,0.2,5,0.2,20,0.8
-86.1575,39.773,1028,0,0,85,0.082684825,85,0.082684825,943,0.917315175,26,0,0,2,0.076923077,2,0.076923077,24,0.923076923
-86.1575,39.7735,2877,0,0,89,0.030935002,89,0.030935002,2788,0.969064998,27,0,0,4,0.148148148,4,0.148148148,23,0.851851852
-86.1575,39.774,3503,0,0,220,0.062803311,220,0.062803311,3283,0.937196689,46,0,0,6,0.130434783,6,0.130434783,40,0.869565217
-86.1575,39.7745,1086,0,0,321,0.29558011,321,0.29558011,765,0.70441989,33,0,0,12,0.363636364,12,0.363636364,21,0.636363636
-86.1575,39.775,3149,0,0,2306,0.732295967,2306,0.732295967,843,0.267704033,49,0,0,28,0.571428571,28,0.571428571,21,0.428571429
-86.1575,39.7755,3113,0,0,2356,0.756826213,2356,0.756826213,757,0.243173787,21,0,0,18,0.857142857,18,0.857142857,3,0.142857143
-86.1575,39.776,509,0,0,426,0.836935167,426,0.836935167,83,0.163064833,9,0,0,6,0.666666667,6,0.666666667,3,0.333333333
-86.1575,39.777,360,0,0,274,0.761111111,274,0.761111111,86,0.238888889,15,0,0,10,0.666666667,10,0.666666667,5,0.333333333
-86.1575,39.7775,4482,0,0,4293,0.957831325,4293,0.957831325,189,0.042168675,30,0,0,19,0.633333333,19,0.633333333,11,0.366666667
-86.1575,39.778,1242,0,0,1136,0.914653784,1136,0.914653784,106,0.085346216,25,0,0,17,0.68,17,0.68,8,0.32
-86.1575,39.779,480,0,0,87,0.18125,87,0.18125,393,0.81875,4,0,0,2,0.5,2,0.5,2,0.5
-86.1575,39.78,93,0,0,93,1,93,1,0,0,1,0,0,1,1,1,1,0,0
-86.1575,39.7805,98,0,0,98,1,98,1,0,0,1,0,0,1,1,1,1,0,0
-86.157,39.761,644,0,0,19,0.029503106,19,0.029503106,625,0.970496894,16,0,0,1,0.0625,1,0.0625,15,0.9375
-86.157,39.7655,482,0,0,332,0.68879668,332,0.68879668,150,0.31120332,35,0,0,20,0.571428571,20,0.571428571,15,0.428571429
-86.157,39.7665,1212,0,0,1186,0.978547855,1186,0.978547855,26,0.021452145,22,0,0,17,0.772727273,17,0.772727273,5,0.227272727
-86.157,39.767,6269,0,0,6023,0.960759292,6023,0.960759292,246,0.039240708,103,0,0,78,0.757281553,78,0.757281553,25,0.242718447
-86.157,39.768,4494,0,0,3886,0.8647085,3886,0.8647085,608,0.1352915,78,0,0,54,0.692307692,54,0.692307692,24,0.307692308
-86.157,39.7685,4167,0,0,4028,0.966642669,4028,0.966642669,139,0.033357331,60,0,0,50,0.833333333,50,0.833333333,10,0.166666667
-86.157,39.7695,4138,0,0,2397,0.579265346,2397,0.579265346,1741,0.420734654,91,0,0,48,0.527472527,48,0.527472527,43,0.472527473
-86.157,39.77,526,0,0,393,0.747148289,393,0.747148289,133,0.252851711,9,0,0,4,0.444444444,4,0.444444444,5,0.555555556
-86.157,39.771,2919,0,0,81,0.027749229,81,0.027749229,2838,0.972250771,26,0,0,3,0.115384615,3,0.115384615,23,0.884615385
-86.157,39.7725,3261,0,0,79,0.024225698,79,0.024225698,3182,0.975774302,5,0,0,1,0.2,1,0.2,4,0.8
-86.157,39.774,1664,0,0,90,0.054086538,90,0.054086538,1574,0.945913462,39,0,0,2,0.051282051,2,0.051282051,37,0.948717949
-86.157,39.775,670,0,0,471,0.702985075,471,0.702985075,199,0.297014925,11,0,0,9,0.818181818,9,0.818181818,2,0.181818182
-86.157,39.7755,916,0,0,888,0.969432314,888,0.969432314,28,0.030567686,9,0,0,8,0.888888889,8,0.888888889,1,0.111111111
-86.157,39.7775,1547,0,0,1491,0.963800905,1491,0.963800905,56,0.036199095,13,0,0,9,0.692307692,9,0.692307692,4,0.307692308
-86.157,39.778,609,0,0,576,0.945812808,576,0.945812808,33,0.054187192,5,0,0,3,0.6,3,0.6,2,0.4
-86.1565,39.761,2147,0,0,330,0.153702841,330,0.153702841,1817,0.846297159,28,0,0,4,0.142857143,4,0.142857143,24,0.857142857
-86.1565,39.7615,801,0,0,0,0,0,0,801,1,11,0,0,0,0,0,0,11,1
-86.1565,39.762,497,0,0,0,0,0,0,497,1,19,0,0,0,0,0,0,19,1
-86.1565,39.7625,510,0,0,0,0,0,0,510,1,7,0,0,0,0,0,0,7,1
-86.1565,39.763,158,0,0,14,0.088607595,14,0.088607595,144,0.911392405,8,0,0,2,0.25,2,0.25,6,0.75
-86.1565,39.7655,1824,0,0,1248,0.684210526,1248,0.684210526,576,0.315789474,24,0,0,16,0.666666667,16,0.666666667,8,0.333333333
-86.1565,39.7665,919,0,0,838,0.911860718,838,0.911860718,81,0.088139282,36,0,0,26,0.722222222,26,0.722222222,10,0.277777778
-86.1565,39.767,6077,0,0,5535,0.910811256,5535,0.910811256,542,0.089188744,123,0,0,86,0.699186992,86,0.699186992,37,0.300813008
-86.1565,39.7675,520,0,0,520,1,520,1,0,0,1,0,0,1,1,1,1,0,0
-86.1565,39.768,377,0,0,362,0.960212202,362,0.960212202,15,0.039787798,10,0,0,7,0.7,7,0.7,3,0.3
-86.1565,39.7685,1530,0,0,1505,0.983660131,1505,0.983660131,25,0.016339869,14,0,0,11,0.785714286,11,0.785714286,3,0.214285714
-86.1565,39.769,648,0,0,648,1,648,1,0,0,4,0,0,4,1,4,1,0,0
-86.1565,39.7695,5516,0,0,4216,0.764321972,4216,0.764321972,1300,0.235678028,115,0,0,67,0.582608696,67,0.582608696,48,0.417391304
-86.1565,39.77,1052,0,0,862,0.819391635,862,0.819391635,190,0.180608365,13,0,0,9,0.692307692,9,0.692307692,4,0.307692308
-86.1565,39.771,3018,0,0,111,0.036779324,111,0.036779324,2907,0.963220676,39,0,0,4,0.102564103,4,0.102564103,35,0.897435897
-86.1565,39.774,846,0,0,34,0.040189125,34,0.040189125,812,0.959810875,9,0,0,1,0.111111111,1,0.111111111,8,0.888888889
-86.1565,39.775,5312,0,0,4814,0.90625,4814,0.90625,498,0.09375,7,0,0,5,0.714285714,5,0.714285714,2,0.285714286
-86.1565,39.7775,330,0,0,268,0.812121212,268,0.812121212,62,0.187878788,17,0,0,11,0.647058824,11,0.647058824,6,0.352941176
-86.156,39.761,3741,0,0,286,0.076450147,286,0.076450147,3455,0.923549853,32,0,0,5,0.15625,5,0.15625,27,0.84375
-86.156,39.7615,591,0,0,0,0,0,0,591,1,11,0,0,0,0,0,0,11,1
-86.156,39.762,515,0,0,0,0,0,0,515,1,15,0,0,0,0,0,0,15,1
-86.156,39.7625,466,0,0,0,0,0,0,466,1,10,0,0,0,0,0,0,10,1
-86.156,39.763,670,0,0,29,0.043283582,29,0.043283582,641,0.956716418,19,0,0,5,0.263157895,5,0.263157895,14,0.736842105
-86.156,39.7635,823,0,0,609,0.739975699,609,0.739975699,214,0.260024301,33,0,0,16,0.484848485,16,0.484848485,17,0.515151515
-86.156,39.764,1860,0,0,1128,0.606451613,1128,0.606451613,732,0.393548387,72,0,0,42,0.583333333,42,0.583333333,30,0.416666667
-86.156,39.7645,2511,0,0,2199,0.875746714,2199,0.875746714,312,0.124253286,42,0,0,26,0.619047619,26,0.619047619,16,0.380952381
-86.156,39.765,1800,0,0,1449,0.805,1449,0.805,351,0.195,23,0,0,17,0.739130435,17,0.739130435,6,0.260869565
-86.156,39.7655,4126,0,0,3248,0.787203102,3248,0.787203102,878,0.212796898,87,0,0,53,0.609195402,53,0.609195402,34,0.390804598
-86.156,39.766,4731,0,0,3605,0.76199535,3605,0.76199535,1126,0.23800465,40,0,0,25,0.625,25,0.625,15,0.375
-86.156,39.7665,4001,0,0,3879,0.969507623,3879,0.969507623,122,0.030492377,36,0,0,31,0.861111111,31,0.861111111,5,0.138888889
-86.156,39.767,10790,0,0,10246,0.949582947,10246,0.949582947,544,0.050417053,181,0,0,123,0.679558011,123,0.679558011,58,0.320441989
-86.156,39.7675,8712,0,0,8277,0.950068871,8277,0.950068871,435,0.049931129,78,0,0,60,0.769230769,60,0.769230769,18,0.230769231
-86.156,39.768,8886,0,0,8191,0.921787081,8191,0.921787081,695,0.078212919,69,0,0,56,0.811594203,56,0.811594203,13,0.188405797
-86.156,39.7685,13017,0,0,11327,0.870169778,11327,0.870169778,1690,0.129830222,133,0,0,94,0.706766917,94,0.706766917,39,0.293233083
-86.156,39.769,7383,0,0,6779,0.918190437,6779,0.918190437,604,0.081809563,125,0,0,80,0.64,80,0.64,45,0.36
-86.156,39.7695,12668,0,0,9202,0.726397221,9202,0.726397221,3466,0.273602779,120,0,0,77,0.641666667,77,0.641666667,43,0.358333333
-86.156,39.77,3058,0,0,2428,0.793982995,2428,0.793982995,630,0.206017005,30,0,0,18,0.6,18,0.6,12,0.4
-86.156,39.7705,2525,0,0,1471,0.582574257,1471,0.582574257,1054,0.417425743,43,0,0,11,0.255813953,11,0.255813953,32,0.744186047
-86.156,39.771,7186,0,0,110,0.015307542,110,0.015307542,7076,0.984692458,33,0,0,4,0.121212121,4,0.121212121,29,0.878787879
-86.156,39.7715,4566,0,0,2,0.00043802,2,0.00043802,4564,0.99956198,32,0,0,1,0.03125,1,0.03125,31,0.96875
-86.156,39.772,14549,0,0,0,0,0,0,14549,1,33,0,0,0,0,0,0,33,1
-86.156,39.7725,3185,0,0,0,0,0,0,3185,1,23,0,0,0,0,0,0,23,1
-86.156,39.773,3788,0,0,0,0,0,0,3788,1,32,0,0,0,0,0,0,32,1
-86.156,39.7735,2573,0,0,0,0,0,0,2573,1,17,0,0,0,0,0,0,17,1
-86.156,39.774,3363,0,0,519,0.154326494,519,0.154326494,2844,0.845673506,29,0,0,7,0.24137931,7,0.24137931,22,0.75862069
-86.156,39.7745,1829,0,0,1182,0.646254784,1182,0.646254784,647,0.353745216,39,0,0,12,0.307692308,12,0.307692308,27,0.692307692
-86.156,39.775,4102,0,0,1321,0.32203803,1321,0.32203803,2781,0.67796197,24,0,0,8,0.333333333,8,0.333333333,16,0.666666667
-86.156,39.7755,1025,0,0,274,0.267317073,274,0.267317073,751,0.732682927,14,0,0,8,0.571428571,8,0.571428571,6,0.428571429
-86.156,39.7775,835,0,0,791,0.947305389,791,0.947305389,44,0.052694611,8,0,0,6,0.75,6,0.75,2,0.25
-86.1555,39.761,1357,0,0,47,0.034635225,47,0.034635225,1310,0.965364775,34,0,0,3,0.088235294,3,0.088235294,31,0.911764706
-86.1555,39.7655,421,0,0,382,0.90736342,382,0.90736342,39,0.09263658,10,0,0,8,0.8,8,0.8,2,0.2
-86.1555,39.7665,1261,0,0,1221,0.968279144,1221,0.968279144,40,0.031720856,28,0,0,19,0.678571429,19,0.678571429,9,0.321428571
-86.1555,39.767,2611,0,0,2485,0.951742627,2485,0.951742627,126,0.048257373,46,0,0,31,0.673913043,31,0.673913043,15,0.326086957
-86.1555,39.768,401,0,0,401,1,401,1,0,0,2,0,0,2,1,2,1,0,0
-86.1555,39.7685,184,0,0,184,1,184,1,0,0,2,0,0,2,1,2,1,0,0
-86.1555,39.769,486,0,0,486,1,486,1,0,0,3,0,0,3,1,3,1,0,0
-86.1555,39.7695,1048,0,0,837,0.798664122,837,0.798664122,211,0.201335878,14,0,0,11,0.785714286,11,0.785714286,3,0.214285714
-86.1555,39.771,11607,0,0,34,0.002929267,34,0.002929267,11573,0.997070733,12,0,0,1,0.083333333,1,0.083333333,11,0.916666667
-86.1555,39.7715,304,0,0,0,0,0,0,304,1,5,0,0,0,0,0,0,5,1
-86.1555,39.772,2737,0,0,0,0,0,0,2737,1,14,0,0,0,0,0,0,14,1
-86.1555,39.7725,2288,0,0,24,0.01048951,24,0.01048951,2264,0.98951049,10,0,0,1,0.1,1,0.1,9,0.9
-86.1555,39.773,2836,0,0,0,0,0,0,2836,1,24,0,0,0,0,0,0,24,1
-86.1555,39.7735,4319,0,0,244,0.056494559,244,0.056494559,4075,0.943505441,21,0,0,2,0.095238095,2,0.095238095,19,0.904761905
-86.1555,39.774,6749,0,0,1319,0.195436361,1319,0.195436361,5430,0.804563639,78,0,0,31,0.397435897,31,0.397435897,47,0.602564103
-86.1555,39.7745,3443,0,0,1905,0.553296544,1905,0.553296544,1538,0.446703456,51,0,0,16,0.31372549,16,0.31372549,35,0.68627451
-86.1555,39.775,7159,0,0,3322,0.464031289,3322,0.464031289,3837,0.535968711,75,0,0,26,0.346666667,26,0.346666667,49,0.653333333
-86.1555,39.7755,2985,0,0,2406,0.806030151,2406,0.806030151,579,0.193969849,34,0,0,21,0.617647059,21,0.617647059,13,0.382352941
-86.1555,39.776,527,0,0,522,0.990512334,522,0.990512334,5,0.009487666,17,0,0,15,0.882352941,15,0.882352941,2,0.117647059
-86.1555,39.7765,719,0,0,660,0.917941586,660,0.917941586,59,0.082058414,23,0,0,14,0.608695652,14,0.608695652,9,0.391304348
-86.1555,39.777,281,0,0,253,0.900355872,253,0.900355872,28,0.099644128,11,0,0,9,0.818181818,9,0.818181818,2,0.181818182
-86.1555,39.7775,1508,0,0,1251,0.829575597,1251,0.829575597,257,0.170424403,11,0,0,10,0.909090909,10,0.909090909,1,0.090909091
-86.1555,39.778,600,0,0,597,0.995,597,0.995,3,0.005,8,0,0,7,0.875,7,0.875,1,0.125
-86.1555,39.7785,125,0,0,125,1,125,1,0,0,3,0,0,3,1,3,1,0,0
-86.1555,39.779,132,0,0,125,0.946969697,125,0.946969697,7,0.053030303,7,0,0,5,0.714285714,5,0.714285714,2,0.285714286
-86.1555,39.7795,156,0,0,141,0.903846154,141,0.903846154,15,0.096153846,8,0,0,5,0.625,5,0.625,3,0.375
-86.1555,39.78,1336,0,0,1286,0.96257485,1286,0.96257485,50,0.03742515,19,0,0,11,0.578947368,11,0.578947368,8,0.421052632
-86.1555,39.7805,467,0,0,412,0.882226981,412,0.882226981,55,0.117773019,3,0,0,1,0.333333333,1,0.333333333,2,0.666666667
-86.155,39.761,2736,0,0,290,0.105994152,290,0.105994152,2446,0.894005848,40,0,0,5,0.125,5,0.125,35,0.875
-86.155,39.7655,539,0,0,413,0.766233766,413,0.766233766,126,0.233766234,24,0,0,15,0.625,15,0.625,9,0.375
-86.155,39.7665,884,0,0,866,0.979638009,866,0.979638009,18,0.020361991,27,0,0,21,0.777777778,21,0.777777778,6,0.222222222
-86.155,39.767,2098,0,0,2088,0.995233556,2088,0.995233556,10,0.004766444,21,0,0,17,0.80952381,17,0.80952381,4,0.19047619
-86.155,39.768,408,0,0,408,1,408,1,0,0,1,0,0,1,1,1,1,0,0
-86.155,39.7695,788,0,0,391,0.496192893,391,0.496192893,397,0.503807107,19,0,0,11,0.578947368,11,0.578947368,8,0.421052632
-86.155,39.771,6401,0,0,218,0.034057179,218,0.034057179,6183,0.965942821,26,0,0,4,0.153846154,4,0.153846154,22,0.846153846
-86.155,39.774,872,0,0,261,0.299311927,261,0.299311927,611,0.700688073,58,0,0,19,0.327586207,19,0.327586207,39,0.672413793
-86.155,39.775,2428,0,0,2196,0.904448105,2196,0.904448105,232,0.095551895,45,0,0,29,0.644444444,29,0.644444444,16,0.355555556
-86.155,39.7755,291,0,0,278,0.95532646,278,0.95532646,13,0.04467354,5,0,0,4,0.8,4,0.8,1,0.2
-86.155,39.7765,95,0,0,93,0.978947368,93,0.978947368,2,0.021052632,4,0,0,3,0.75,3,0.75,1,0.25
-86.155,39.7775,311,0,0,255,0.819935691,255,0.819935691,56,0.180064309,14,0,0,9,0.642857143,9,0.642857143,5,0.357142857
-86.155,39.78,114,0,0,114,1,114,1,0,0,2,0,0,2,1,2,1,0,0
-86.1545,39.761,3788,0,0,134,0.035374868,134,0.035374868,3654,0.964625132,38,0,0,4,0.105263158,4,0.105263158,34,0.894736842
-86.1545,39.7615,915,0,0,29,0.031693989,29,0.031693989,886,0.968306011,17,0,0,1,0.058823529,1,0.058823529,16,0.941176471
-86.1545,39.762,1766,0,0,0,0,0,0,1766,1,33,0,0,0,0,0,0,33,1
-86.1545,39.7625,1628,0,0,0,0,0,0,1628,1,8,0,0,0,0,0,0,8,1
-86.1545,39.763,940,0,0,0,0,0,0,940,1,8,0,0,0,0,0,0,8,1
-86.1545,39.7635,1228,0,0,672,0.54723127,672,0.54723127,556,0.45276873,52,0,0,18,0.346153846,18,0.346153846,34,0.653846154
-86.1545,39.764,980,0,0,980,1,980,1,0,0,31,0,0,31,1,31,1,0,0
-86.1545,39.7645,2076,0,0,2076,1,2076,1,0,0,12,0,0,12,1,12,1,0,0
-86.1545,39.765,4668,0,0,4601,0.985646958,4601,0.985646958,67,0.014353042,52,0,0,36,0.692307692,36,0.692307692,16,0.307692308
-86.1545,39.7655,4864,0,0,4504,0.925986842,4504,0.925986842,360,0.074013158,34,0,0,30,0.882352941,30,0.882352941,4,0.117647059
-86.1545,39.766,6444,0,0,5518,0.856300435,5518,0.856300435,926,0.143699565,61,0,0,41,0.672131148,41,0.672131148,20,0.327868852
-86.1545,39.7665,3893,0,0,3800,0.976110968,3800,0.976110968,93,0.023889032,71,0,0,54,0.76056338,54,0.76056338,17,0.23943662
-86.1545,39.767,2972,0,0,2972,1,2972,1,0,0,22,0,0,22,1,22,1,0,0
-86.1545,39.7675,100,0,0,98,0.98,98,0.98,2,0.02,8,0,0,7,0.875,7,0.875,1,0.125
-86.1545,39.7685,256,0,0,256,1,256,1,0,0,2,0,0,2,1,2,1,0,0
-86.1545,39.769,189,0,0,187,0.989417989,187,0.989417989,2,0.010582011,4,0,0,3,0.75,3,0.75,1,0.25
-86.1545,39.7695,3011,0,0,1920,0.637661906,1920,0.637661906,1091,0.362338094,44,0,0,23,0.522727273,23,0.522727273,21,0.477272727
-86.1545,39.771,7804,0,0,5029,0.644413121,5029,0.644413121,2775,0.355586879,107,0,0,50,0.46728972,50,0.46728972,57,0.53271028
-86.1545,39.7725,142,0,0,142,1,142,1,0,0,1,0,0,1,1,1,1,0,0
-86.1545,39.7735,62,0,0,0,0,0,0,62,1,1,0,0,0,0,0,0,1,1
-86.1545,39.774,750,0,0,29,0.038666667,29,0.038666667,721,0.961333333,11,0,0,1,0.090909091,1,0.090909091,10,0.909090909
-86.1545,39.775,875,0,0,710,0.811428571,710,0.811428571,165,0.188571429,24,0,0,18,0.75,18,0.75,6,0.25
-86.1545,39.7755,132,0,0,132,1,132,1,0,0,5,0,0,5,1,5,1,0,0
-86.1545,39.7775,262,0,0,225,0.858778626,225,0.858778626,37,0.141221374,9,0,0,7,0.777777778,7,0.777777778,2,0.222222222
-86.154,39.761,1746,0,0,188,0.107674685,188,0.107674685,1558,0.892325315,17,0,0,5,0.294117647,5,0.294117647,12,0.705882353
-86.154,39.7645,241,0,0,238,0.987551867,238,0.987551867,3,0.012448133,5,0,0,4,0.8,4,0.8,1,0.2
-86.154,39.765,431,0,0,427,0.990719258,427,0.990719258,4,0.009280742,9,0,0,8,0.888888889,8,0.888888889,1,0.111111111
-86.154,39.7665,1786,0,0,1786,1,1786,1,0,0,16,0,0,16,1,16,1,0,0
-86.154,39.767,2069,0,0,2063,0.997100048,2063,0.997100048,6,0.002899952,23,0,0,22,0.956521739,22,0.956521739,1,0.043478261
-86.154,39.7675,1427,0,0,1280,0.896986685,1280,0.896986685,147,0.103013315,64,0,0,45,0.703125,45,0.703125,19,0.296875
-86.154,39.768,1328,0,0,1310,0.986445783,1310,0.986445783,18,0.013554217,21,0,0,16,0.761904762,16,0.761904762,5,0.238095238
-86.154,39.7685,2728,0,0,2699,0.989369501,2699,0.989369501,29,0.010630499,20,0,0,17,0.85,17,0.85,3,0.15
-86.154,39.769,3108,0,0,2497,0.803410553,2497,0.803410553,611,0.196589447,49,0,0,28,0.571428571,28,0.571428571,21,0.428571429
-86.154,39.7695,3804,0,0,2975,0.782071504,2975,0.782071504,829,0.217928496,52,0,0,35,0.673076923,35,0.673076923,17,0.326923077
-86.154,39.77,1698,0,0,1551,0.913427562,1551,0.913427562,147,0.086572438,28,0,0,23,0.821428571,23,0.821428571,5,0.178571429
-86.154,39.7705,1657,0,0,1408,0.849728425,1408,0.849728425,249,0.150271575,64,0,0,43,0.671875,43,0.671875,21,0.328125
-86.154,39.771,3937,0,0,3665,0.930911862,3665,0.930911862,272,0.069088138,97,0,0,73,0.75257732,73,0.75257732,24,0.24742268
-86.154,39.7715,1904,0,0,1813,0.952205882,1813,0.952205882,91,0.047794118,50,0,0,38,0.76,38,0.76,12,0.24
-86.154,39.772,3168,0,0,2892,0.912878788,2892,0.912878788,276,0.087121212,75,0,0,49,0.653333333,49,0.653333333,26,0.346666667
-86.154,39.7725,1594,0,0,1432,0.898368883,1432,0.898368883,162,0.101631117,34,0,0,26,0.764705882,26,0.764705882,8,0.235294118
-86.154,39.773,4033,0,0,3548,0.879742127,3548,0.879742127,485,0.120257873,41,0,0,30,0.731707317,30,0.731707317,11,0.268292683
-86.154,39.7735,3653,0,0,499,0.136600055,499,0.136600055,3154,0.863399945,46,0,0,22,0.47826087,22,0.47826087,24,0.52173913
-86.154,39.774,2451,0,0,43,0.01754386,43,0.01754386,2408,0.98245614,14,0,0,1,0.071428571,1,0.071428571,13,0.928571429
-86.154,39.7745,1304,0,0,0,0,0,0,1304,1,8,0,0,0,0,0,0,8,1
-86.154,39.775,2916,0,0,1448,0.496570645,1448,0.496570645,1468,0.503429355,106,0,0,41,0.386792453,41,0.386792453,65,0.613207547
-86.154,39.7755,1057,0,0,820,0.775780511,820,0.775780511,237,0.224219489,32,0,0,16,0.5,16,0.5,16,0.5
-86.154,39.776,688,0,0,14,0.020348837,14,0.020348837,674,0.979651163,10,0,0,2,0.2,2,0.2,8,0.8
-86.154,39.7765,1795,0,0,60,0.033426184,60,0.033426184,1735,0.966573816,10,0,0,2,0.2,2,0.2,8,0.8
-86.154,39.777,360,0,0,75,0.208333333,75,0.208333333,285,0.791666667,9,0,0,2,0.222222222,2,0.222222222,7,0.777777778
-86.154,39.7775,812,0,0,599,0.737684729,599,0.737684729,213,0.262315271,29,0,0,13,0.448275862,13,0.448275862,16,0.551724138
-86.154,39.779,120,0,0,120,1,120,1,0,0,2,0,0,2,1,2,1,0,0
-86.154,39.7795,152,0,0,152,1,152,1,0,0,2,0,0,2,1,2,1,0,0
-86.154,39.78,163,0,0,163,1,163,1,0,0,2,0,0,2,1,2,1,0,0
-86.1535,39.761,316,0,0,19,0.060126582,19,0.060126582,297,0.939873418,17,0,0,4,0.235294118,4,0.235294118,13,0.764705882
-86.1535,39.7665,4827,0,0,4720,0.977833023,4720,0.977833023,107,0.022166977,34,0,0,24,0.705882353,24,0.705882353,10,0.294117647
-86.1535,39.767,456,0,0,423,0.927631579,423,0.927631579,33,0.072368421,22,0,0,14,0.636363636,14,0.636363636,8,0.363636364
-86.1535,39.7695,743,0,0,556,0.748317631,556,0.748317631,187,0.251682369,32,0,0,16,0.5,16,0.5,16,0.5
-86.1535,39.771,1173,0,0,1017,0.867007673,1017,0.867007673,156,0.132992327,63,0,0,40,0.634920635,40,0.634920635,23,0.365079365
-86.1535,39.7725,4991,0,0,4912,0.984171509,4912,0.984171509,79,0.015828491,9,0,0,6,0.666666667,6,0.666666667,3,0.333333333
-86.1535,39.7735,624,0,0,65,0.104166667,65,0.104166667,559,0.895833333,13,0,0,6,0.461538462,6,0.461538462,7,0.538461538
-86.1535,39.774,3214,0,0,538,0.167392657,538,0.167392657,2676,0.832607343,31,0,0,12,0.387096774,12,0.387096774,19,0.612903226
-86.1535,39.775,1909,0,0,1769,0.926663174,1769,0.926663174,140,0.073336826,24,0,0,20,0.833333333,20,0.833333333,4,0.166666667
-86.1535,39.7775,1403,0,0,1356,0.966500356,1356,0.966500356,47,0.033499644,19,0,0,13,0.684210526,13,0.684210526,6,0.315789474
-86.153,39.761,392,0,0,30,0.076530612,30,0.076530612,362,0.923469388,11,0,0,1,0.090909091,1,0.090909091,10,0.909090909
-86.153,39.765,93,0,0,93,1,93,1,0,0,2,0,0,2,1,2,1,0,0
-86.153,39.7655,61,0,0,61,1,61,1,0,0,2,0,0,2,1,2,1,0,0
-86.153,39.7665,5264,0,0,5206,0.988981763,5206,0.988981763,58,0.011018237,26,0,0,19,0.730769231,19,0.730769231,7,0.269230769
-86.153,39.767,286,0,0,285,0.996503497,285,0.996503497,1,0.003496503,5,0,0,4,0.8,4,0.8,1,0.2
-86.153,39.7695,669,0,0,190,0.284005979,190,0.284005979,479,0.715994021,30,0,0,13,0.433333333,13,0.433333333,17,0.566666667
-86.153,39.771,1156,0,0,1028,0.889273356,1028,0.889273356,128,0.110726644,41,0,0,28,0.682926829,28,0.682926829,13,0.317073171
-86.153,39.7725,334,0,0,275,0.823353293,275,0.823353293,59,0.176646707,4,0,0,3,0.75,3,0.75,1,0.25
-86.153,39.7735,4022,0,0,2941,0.731228245,2941,0.731228245,1081,0.268771755,39,0,0,24,0.615384615,24,0.615384615,15,0.384615385
-86.153,39.774,649,0,0,549,0.845916795,549,0.845916795,100,0.154083205,25,0,0,15,0.6,15,0.6,10,0.4
-86.153,39.775,1010,0,0,657,0.65049505,657,0.65049505,353,0.34950495,29,0,0,17,0.586206897,17,0.586206897,12,0.413793103
-86.153,39.7775,1084,0,0,1010,0.931734317,1010,0.931734317,74,0.068265683,17,0,0,12,0.705882353,12,0.705882353,5,0.294117647
-86.1525,39.761,1097,0,0,33,0.030082042,33,0.030082042,1064,0.969917958,10,0,0,1,0.1,1,0.1,9,0.9
-86.1525,39.764,62,0,0,62,1,62,1,0,0,1,0,0,1,1,1,1,0,0
-86.1525,39.765,132,0,0,123,0.931818182,123,0.931818182,9,0.068181818,5,0,0,3,0.6,3,0.6,2,0.4
-86.1525,39.7655,8223,0,0,7875,0.957679679,7875,0.957679679,348,0.042320321,79,0,0,51,0.64556962,51,0.64556962,28,0.35443038
-86.1525,39.766,2962,0,0,2874,0.970290344,2874,0.970290344,88,0.029709656,63,0,0,43,0.682539683,43,0.682539683,20,0.317460317
-86.1525,39.7665,5991,0,0,5958,0.994491738,5958,0.994491738,33,0.005508262,43,0,0,40,0.930232558,40,0.930232558,3,0.069767442
-86.1525,39.767,5832,0,0,5722,0.981138546,5722,0.981138546,110,0.018861454,85,0,0,59,0.694117647,59,0.694117647,26,0.305882353
-86.1525,39.7675,1818,0,0,1763,0.969746975,1763,0.969746975,55,0.030253025,53,0,0,39,0.735849057,39,0.735849057,14,0.264150943
-86.1525,39.768,2210,0,0,2194,0.992760181,2194,0.992760181,16,0.007239819,49,0,0,45,0.918367347,45,0.918367347,4,0.081632653
-86.1525,39.7685,13097,0,0,12804,0.977628465,12804,0.977628465,293,0.022371535,71,0,0,40,0.563380282,40,0.563380282,31,0.436619718
-86.1525,39.769,3424,0,0,1441,0.420852804,1441,0.420852804,1983,0.579147196,65,0,0,16,0.246153846,16,0.246153846,49,0.753846154
-86.1525,39.7695,5170,0,0,69,0.013346228,69,0.013346228,5101,0.986653772,38,0,0,3,0.078947368,3,0.078947368,35,0.921052632
-86.1525,39.77,3941,0,0,1626,0.412585638,1626,0.412585638,2315,0.587414362,55,0,0,31,0.563636364,31,0.563636364,24,0.436363636
-86.1525,39.7705,1497,0,0,1458,0.973947896,1458,0.973947896,39,0.026052104,23,0,0,22,0.956521739,22,0.956521739,1,0.043478261
-86.1525,39.771,3228,0,0,3190,0.988228005,3190,0.988228005,38,0.011771995,46,0,0,41,0.891304348,41,0.891304348,5,0.108695652
-86.1525,39.7715,608,0,0,504,0.828947368,504,0.828947368,104,0.171052632,42,0,0,28,0.666666667,28,0.666666667,14,0.333333333
-86.1525,39.772,340,0,0,331,0.973529412,331,0.973529412,9,0.026470588,14,0,0,12,0.857142857,12,0.857142857,2,0.142857143
-86.1525,39.7725,2032,0,0,1277,0.628444882,1277,0.628444882,755,0.371555118,19,0,0,11,0.578947368,11,0.578947368,8,0.421052632
-86.1525,39.773,267,0,0,32,0.119850187,32,0.119850187,235,0.880149813,17,0,0,3,0.176470588,3,0.176470588,14,0.823529412
-86.1525,39.7735,1231,0,0,738,0.599512591,738,0.599512591,493,0.400487409,39,0,0,25,0.641025641,25,0.641025641,14,0.358974359
-86.1525,39.774,873,0,0,794,0.909507446,794,0.909507446,79,0.090492554,26,0,0,17,0.653846154,17,0.653846154,9,0.346153846
-86.1525,39.775,1614,0,0,404,0.250309789,404,0.250309789,1210,0.749690211,31,0,0,11,0.35483871,11,0.35483871,20,0.64516129
-86.1525,39.7775,847,0,0,737,0.87012987,737,0.87012987,110,0.12987013,21,0,0,13,0.619047619,13,0.619047619,8,0.380952381
-86.152,39.761,361,0,0,32,0.088642659,32,0.088642659,329,0.911357341,9,0,0,1,0.111111111,1,0.111111111,8,0.888888889
-86.152,39.7655,1177,0,0,1165,0.989804588,1165,0.989804588,12,0.010195412,28,0,0,25,0.892857143,25,0.892857143,3,0.107142857
-86.152,39.766,153,0,0,153,1,153,1,0,0,17,0,0,17,1,17,1,0,0
-86.152,39.7665,2172,0,0,2160,0.994475138,2160,0.994475138,12,0.005524862,15,0,0,11,0.733333333,11,0.733333333,4,0.266666667
-86.152,39.767,175,0,0,170,0.971428571,170,0.971428571,5,0.028571429,6,0,0,4,0.666666667,4,0.666666667,2,0.333333333
-86.152,39.7695,3334,0,0,0,0,0,0,3334,1,12,0,0,0,0,0,0,12,1
-86.152,39.7705,73,0,0,73,1,73,1,0,0,2,0,0,2,1,2,1,0,0
-86.152,39.771,1055,0,0,1017,0.963981043,1017,0.963981043,38,0.036018957,24,0,0,22,0.916666667,22,0.916666667,2,0.083333333
-86.152,39.7715,524,0,0,460,0.877862595,460,0.877862595,64,0.122137405,27,0,0,18,0.666666667,18,0.666666667,9,0.333333333
-86.152,39.772,648,0,0,563,0.86882716,563,0.86882716,85,0.13117284,24,0,0,15,0.625,15,0.625,9,0.375
-86.152,39.7725,3618,0,0,2756,0.761746821,2756,0.761746821,862,0.238253179,40,0,0,22,0.55,22,0.55,18,0.45
-86.152,39.773,755,0,0,361,0.478145695,361,0.478145695,394,0.521854305,33,0,0,11,0.333333333,11,0.333333333,22,0.666666667
-86.152,39.7735,1453,0,0,1009,0.694425327,1009,0.694425327,444,0.305574673,39,0,0,24,0.615384615,24,0.615384615,15,0.384615385
-86.152,39.774,3522,0,0,1912,0.542873367,1912,0.542873367,1610,0.457126633,68,0,0,30,0.441176471,30,0.441176471,38,0.558823529
-86.152,39.7745,1161,0,0,214,0.184323859,214,0.184323859,947,0.815676141,32,0,0,12,0.375,12,0.375,20,0.625
-86.152,39.775,2582,0,0,747,0.289310612,747,0.289310612,1835,0.710689388,39,0,0,11,0.282051282,11,0.282051282,28,0.717948718
-86.152,39.7755,5683,0,0,2235,0.393278198,2235,0.393278198,3448,0.606721802,45,0,0,28,0.622222222,28,0.622222222,17,0.377777778
-86.152,39.776,834,0,0,773,0.926858513,773,0.926858513,61,0.073141487,50,0,0,36,0.72,36,0.72,14,0.28
-86.152,39.7765,764,0,0,751,0.982984293,751,0.982984293,13,0.017015707,20,0,0,18,0.9,18,0.9,2,0.1
-86.152,39.777,962,0,0,962,1,962,1,0,0,15,0,0,15,1,15,1,0,0
-86.152,39.7775,4608,0,0,4515,0.979817708,4515,0.979817708,93,0.020182292,33,0,0,24,0.727272727,24,0.727272727,9,0.272727273
-86.152,39.778,206,0,0,206,1,206,1,0,0,2,0,0,2,1,2,1,0,0
-86.152,39.7785,805,0,0,770,0.956521739,770,0.956521739,35,0.043478261,9,0,0,3,0.333333333,3,0.333333333,6,0.666666667
-86.152,39.7805,122,0,0,122,1,122,1,0,0,3,0,0,3,1,3,1,0,0
-86.1515,39.761,344,0,0,28,0.081395349,28,0.081395349,316,0.918604651,9,0,0,1,0.111111111,1,0.111111111,8,0.888888889
-86.1515,39.766,1147,0,0,1118,0.974716652,1118,0.974716652,29,0.025283348,39,0,0,30,0.769230769,30,0.769230769,9,0.230769231
-86.1515,39.7665,3749,0,0,3719,0.991997866,3719,0.991997866,30,0.008002134,47,0,0,37,0.787234043,37,0.787234043,10,0.212765957
-86.1515,39.767,108,0,0,100,0.925925926,100,0.925925926,8,0.074074074,8,0,0,5,0.625,5,0.625,3,0.375
-86.1515,39.7695,647,0,0,13,0.020092736,13,0.020092736,634,0.979907264,16,0,0,3,0.1875,3,0.1875,13,0.8125
-86.1515,39.771,9362,0,0,9349,0.998611408,9349,0.998611408,13,0.001388592,28,0,0,25,0.892857143,25,0.892857143,3,0.107142857
-86.1515,39.7725,60,0,0,60,1,60,1,0,0,1,0,0,1,1,1,1,0,0
-86.1515,39.7735,1001,0,0,927,0.926073926,927,0.926073926,74,0.073926074,47,0,0,32,0.680851064,32,0.680851064,15,0.319148936
-86.1515,39.775,840,0,0,564,0.671428571,564,0.671428571,276,0.328571429,19,0,0,9,0.473684211,9,0.473684211,10,0.526315789
-86.1515,39.7775,3450,0,0,2849,0.825797101,2849,0.825797101,601,0.174202899,35,0,0,25,0.714285714,25,0.714285714,10,0.285714286
-86.1515,39.7785,93,0,0,93,1,93,1,0,0,1,0,0,1,1,1,1,0,0
-86.151,39.761,481,0,0,96,0.1995842,96,0.1995842,385,0.8004158,13,0,0,4,0.307692308,4,0.307692308,9,0.692307692
-86.151,39.7625,294,0,0,294,1,294,1,0,0,1,0,0,1,1,1,1,0,0
-86.151,39.7665,7309,0,0,7254,0.992475031,7254,0.992475031,55,0.007524969,57,0,0,43,0.754385965,43,0.754385965,14,0.245614035
-86.151,39.7695,1744,0,0,1021,0.58543578,1021,0.58543578,723,0.41456422,35,0,0,17,0.485714286,17,0.485714286,18,0.514285714
-86.151,39.771,1800,0,0,1791,0.995,1791,0.995,9,0.005,24,0,0,22,0.916666667,22,0.916666667,2,0.083333333
-86.151,39.7735,603,0,0,580,0.96185738,580,0.96185738,23,0.03814262,18,0,0,16,0.888888889,16,0.888888889,2,0.111111111
-86.151,39.775,476,0,0,277,0.581932773,277,0.581932773,199,0.418067227,25,0,0,12,0.48,12,0.48,13,0.52
-86.151,39.7775,1007,0,0,965,0.958291956,965,0.958291956,42,0.041708044,20,0,0,17,0.85,17,0.85,3,0.15
-86.1505,39.761,591,0,0,267,0.45177665,267,0.45177665,324,0.54822335,10,0,0,4,0.4,4,0.4,6,0.6
-86.1505,39.7665,5905,0,0,5905,1,5905,1,0,0,30,0,0,30,1,30,1,0,0
-86.1505,39.767,1707,0,0,1706,0.999414177,1706,0.999414177,1,0.000585823,23,0,0,22,0.956521739,22,0.956521739,1,0.043478261
-86.1505,39.7675,2190,0,0,312,0.142465753,312,0.142465753,1878,0.857534247,48,0,0,25,0.520833333,25,0.520833333,23,0.479166667
-86.1505,39.768,4705,0,0,109,0.023166844,109,0.023166844,4596,0.976833156,22,0,0,2,0.090909091,2,0.090909091,20,0.909090909
-86.1505,39.7685,2531,0,0,142,0.056104307,142,0.056104307,2389,0.943895693,25,0,0,3,0.12,3,0.12,22,0.88
-86.1505,39.769,5991,0,0,3756,0.626940411,3756,0.626940411,2235,0.373059589,95,0,0,41,0.431578947,41,0.431578947,54,0.568421053
-86.1505,39.7695,4543,0,0,4496,0.989654413,4496,0.989654413,47,0.010345587,67,0,0,53,0.791044776,53,0.791044776,14,0.208955224
-86.1505,39.77,1473,0,0,1473,1,1473,1,0,0,22,0,0,22,1,22,1,0,0
-86.1505,39.7705,1449,0,0,1449,1,1449,1,0,0,26,0,0,26,1,26,1,0,0
-86.1505,39.771,2845,0,0,2627,0.923374341,2627,0.923374341,218,0.076625659,96,0,0,69,0.71875,69,0.71875,27,0.28125
-86.1505,39.7715,1171,0,0,1088,0.92912041,1088,0.92912041,83,0.07087959,45,0,0,32,0.711111111,32,0.711111111,13,0.288888889
-86.1505,39.772,2039,0,0,1652,0.810201079,1652,0.810201079,387,0.189798921,81,0,0,51,0.62962963,51,0.62962963,30,0.37037037
-86.1505,39.7725,1764,0,0,1631,0.924603175,1631,0.924603175,133,0.075396825,68,0,0,44,0.647058824,44,0.647058824,24,0.352941176
-86.1505,39.773,3245,0,0,3147,0.969799692,3147,0.969799692,98,0.030200308,55,0,0,43,0.781818182,43,0.781818182,12,0.218181818
-86.1505,39.7735,6223,0,0,6159,0.989715571,6159,0.989715571,64,0.010284429,62,0,0,54,0.870967742,54,0.870967742,8,0.129032258
-86.1505,39.774,1044,0,0,946,0.906130268,946,0.906130268,98,0.093869732,33,0,0,24,0.727272727,24,0.727272727,9,0.272727273
-86.1505,39.7745,1313,0,0,1036,0.789032749,1036,0.789032749,277,0.210967251,33,0,0,27,0.818181818,27,0.818181818,6,0.181818182
-86.1505,39.775,3122,0,0,2921,0.935618193,2921,0.935618193,201,0.064381807,72,0,0,49,0.680555556,49,0.680555556,23,0.319444444
-86.1505,39.7755,534,0,0,443,0.829588015,443,0.829588015,91,0.170411985,44,0,0,25,0.568181818,25,0.568181818,19,0.431818182
-86.1505,39.776,85,0,0,85,1,85,1,0,0,6,0,0,6,1,6,1,0,0
-86.1505,39.777,82,0,0,82,1,82,1,0,0,3,0,0,3,1,3,1,0,0
-86.1505,39.7775,1139,0,0,1118,0.981562774,1118,0.981562774,21,0.018437226,20,0,0,19,0.95,19,0.95,1,0.05
-86.15,39.7665,2152,0,0,2077,0.965148699,2077,0.965148699,75,0.034851301,55,0,0,36,0.654545455,36,0.654545455,19,0.345454545
-86.15,39.7695,854,0,0,845,0.989461358,845,0.989461358,9,0.010538642,18,0,0,16,0.888888889,16,0.888888889,2,0.111111111
-86.15,39.771,788,0,0,614,0.779187817,614,0.779187817,174,0.220812183,44,0,0,23,0.522727273,23,0.522727273,21,0.477272727
-86.15,39.7725,74,0,0,74,1,74,1,0,0,2,0,0,2,1,2,1,0,0
-86.15,39.7735,1995,0,0,1946,0.975438596,1946,0.975438596,49,0.024561404,31,0,0,22,0.709677419,22,0.709677419,9,0.290322581
-86.15,39.775,1247,0,0,1174,0.941459503,1174,0.941459503,73,0.058540497,37,0,0,26,0.702702703,26,0.702702703,11,0.297297297
-86.15,39.7755,442,0,0,339,0.766968326,339,0.766968326,103,0.233031674,41,0,0,21,0.512195122,21,0.512195122,20,0.487804878
-86.15,39.776,1404,0,0,1365,0.972222222,1365,0.972222222,39,0.027777778,25,0,0,16,0.64,16,0.64,9,0.36
-86.15,39.7765,1588,0,0,1566,0.986146096,1566,0.986146096,22,0.013853904,20,0,0,15,0.75,15,0.75,5,0.25
-86.15,39.777,1203,0,0,1203,1,1203,1,0,0,12,0,0,12,1,12,1,0,0
-86.15,39.7775,2598,0,0,2572,0.989992302,2572,0.989992302,26,0.010007698,27,0,0,23,0.851851852,23,0.851851852,4,0.148148148
-86.1495,39.761,2169,0,0,1735,0.799907792,1735,0.799907792,434,0.200092208,16,0,0,8,0.5,8,0.5,8,0.5
-86.1495,39.7615,72,0,0,72,1,72,1,0,0,1,0,0,1,1,1,1,0,0
-86.1495,39.7665,2141,0,0,2124,0.992059785,2124,0.992059785,17,0.007940215,24,0,0,20,0.833333333,20,0.833333333,4,0.166666667
-86.1495,39.7695,548,0,0,538,0.981751825,538,0.981751825,10,0.018248175,15,0,0,13,0.866666667,13,0.866666667,2,0.133333333
-86.1495,39.771,782,0,0,120,0.153452685,120,0.153452685,662,0.846547315,38,0,0,10,0.263157895,10,0.263157895,28,0.736842105
-86.1495,39.7735,802,0,0,696,0.867830424,696,0.867830424,106,0.132169576,36,0,0,24,0.666666667,24,0.666666667,12,0.333333333
-86.1495,39.775,299,0,0,295,0.986622074,295,0.986622074,4,0.013377926,11,0,0,10,0.909090909,10,0.909090909,1,0.090909091
-86.1495,39.7775,695,0,0,695,1,695,1,0,0,7,0,0,7,1,7,1,0,0
-86.149,39.761,659,0,0,607,0.921092564,607,0.921092564,52,0.078907436,10,0,0,9,0.9,9,0.9,1,0.1
-86.149,39.7615,1866,0,0,1866,1,1866,1,0,0,7,0,0,7,1,7,1,0,0
-86.149,39.762,582,0,0,582,1,582,1,0,0,7,0,0,7,1,7,1,0,0
-86.149,39.7625,410,0,0,410,1,410,1,0,0,7,0,0,7,1,7,1,0,0
-86.149,39.763,393,0,0,393,1,393,1,0,0,7,0,0,7,1,7,1,0,0
-86.149,39.7635,407,0,0,407,1,407,1,0,0,7,0,0,7,1,7,1,0,0
-86.149,39.764,1641,0,0,1641,1,1641,1,0,0,7,0,0,7,1,7,1,0,0
-86.149,39.7645,405,0,0,369,0.911111111,369,0.911111111,36,0.088888889,25,0,0,17,0.68,17,0.68,8,0.32
-86.149,39.765,400,0,0,388,0.97,388,0.97,12,0.03,14,0,0,12,0.857142857,12,0.857142857,2,0.142857143
-86.149,39.7655,411,0,0,411,1,411,1,0,0,14,0,0,14,1,14,1,0,0
-86.149,39.766,703,0,0,703,1,703,1,0,0,11,0,0,11,1,11,1,0,0
-86.149,39.7665,3120,0,0,3120,1,3120,1,0,0,27,0,0,27,1,27,1,0,0
-86.149,39.767,2552,0,0,2552,1,2552,1,0,0,19,0,0,19,1,19,1,0,0
-86.149,39.7675,1022,0,0,1010,0.988258317,1010,0.988258317,12,0.011741683,21,0,0,18,0.857142857,18,0.857142857,3,0.142857143
-86.149,39.768,750,0,0,589,0.785333333,589,0.785333333,161,0.214666667,33,0,0,24,0.727272727,24,0.727272727,9,0.272727273
-86.149,39.7685,2197,0,0,2103,0.957214383,2103,0.957214383,94,0.042785617,51,0,0,31,0.607843137,31,0.607843137,20,0.392156863
-86.149,39.7695,1895,0,0,1855,0.978891821,1855,0.978891821,40,0.021108179,27,0,0,20,0.740740741,20,0.740740741,7,0.259259259
-86.149,39.771,2172,0,0,1788,0.82320442,1788,0.82320442,384,0.17679558,53,0,0,19,0.358490566,19,0.358490566,34,0.641509434
-86.149,39.7735,816,0,0,814,0.99754902,814,0.99754902,2,0.00245098,23,0,0,22,0.956521739,22,0.956521739,1,0.043478261
-86.149,39.774,80,0,0,80,1,80,1,0,0,1,0,0,1,1,1,1,0,0
-86.149,39.775,2656,0,0,2649,0.997364458,2649,0.997364458,7,0.002635542,15,0,0,13,0.866666667,13,0.866666667,2,0.133333333
-86.149,39.7775,825,0,0,825,1,825,1,0,0,7,0,0,7,1,7,1,0,0
-86.1485,39.7665,78,0,0,78,1,78,1,0,0,4,0,0,4,1,4,1,0,0
-86.1485,39.767,348,0,0,348,1,348,1,0,0,1,0,0,1,1,1,1,0,0
-86.1485,39.7675,159,0,0,159,1,159,1,0,0,4,0,0,4,1,4,1,0,0
-86.1485,39.768,1252,0,0,1132,0.904153355,1132,0.904153355,120,0.095846645,26,0,0,18,0.692307692,18,0.692307692,8,0.307692308
-86.1485,39.7685,2064,0,0,1938,0.938953488,1938,0.938953488,126,0.061046512,67,0,0,39,0.582089552,39,0.582089552,28,0.417910448
-86.1485,39.769,1993,0,0,1872,0.939287506,1872,0.939287506,121,0.060712494,66,0,0,44,0.666666667,44,0.666666667,22,0.333333333
-86.1485,39.7695,3213,0,0,3129,0.973856209,3129,0.973856209,84,0.026143791,58,0,0,39,0.672413793,39,0.672413793,19,0.327586207
-86.1485,39.77,3389,0,0,3324,0.980820301,3324,0.980820301,65,0.019179699,38,0,0,24,0.631578947,24,0.631578947,14,0.368421053
-86.1485,39.7705,2376,0,0,2376,1,2376,1,0,0,11,0,0,11,1,11,1,0,0
-86.1485,39.771,1911,0,0,1896,0.992150706,1896,0.992150706,15,0.007849294,31,0,0,25,0.806451613,25,0.806451613,6,0.193548387
-86.1485,39.7715,509,0,0,509,1,509,1,0,0,6,0,0,6,1,6,1,0,0
-86.1485,39.772,424,0,0,424,1,424,1,0,0,9,0,0,9,1,9,1,0,0
-86.1485,39.7725,900,0,0,876,0.973333333,876,0.973333333,24,0.026666667,14,0,0,12,0.857142857,12,0.857142857,2,0.142857143
-86.1485,39.773,511,0,0,484,0.947162427,484,0.947162427,27,0.052837573,21,0,0,15,0.714285714,15,0.714285714,6,0.285714286
-86.1485,39.7735,3457,0,0,3359,0.971651721,3359,0.971651721,98,0.028348279,52,0,0,41,0.788461538,41,0.788461538,11,0.211538462
-86.1485,39.774,1145,0,0,1145,1,1145,1,0,0,7,0,0,7,1,7,1,0,0
-86.1485,39.7745,534,0,0,534,1,534,1,0,0,9,0,0,9,1,9,1,0,0
-86.1485,39.775,1310,0,0,1241,0.947328244,1241,0.947328244,69,0.052671756,27,0,0,21,0.777777778,21,0.777777778,6,0.222222222
-86.1485,39.7755,1845,0,0,1815,0.983739837,1815,0.983739837,30,0.016260163,24,0,0,17,0.708333333,17,0.708333333,7,0.291666667
-86.1485,39.776,249,0,0,237,0.951807229,237,0.951807229,12,0.048192771,11,0,0,8,0.727272727,8,0.727272727,3,0.272727273
-86.1485,39.7765,482,0,0,476,0.987551867,476,0.987551867,6,0.012448133,9,0,0,8,0.888888889,8,0.888888889,1,0.111111111
-86.1485,39.777,636,0,0,627,0.985849057,627,0.985849057,9,0.014150943,11,0,0,9,0.818181818,9,0.818181818,2,0.181818182
-86.1485,39.7775,2175,0,0,2151,0.988965517,2151,0.988965517,24,0.011034483,22,0,0,16,0.727272727,16,0.727272727,6,0.272727273
-86.1485,39.778,107,0,0,107,1,107,1,0,0,2,0,0,2,1,2,1,0,0
-86.1485,39.7785,85,0,0,85,1,85,1,0,0,2,0,0,2,1,2,1,0,0
-86.1485,39.779,79,0,0,77,0.974683544,77,0.974683544,2,0.025316456,3,0,0,2,0.666666667,2,0.666666667,1,0.333333333
-86.1485,39.78,101,0,0,101,1,101,1,0,0,2,0,0,2,1,2,1,0,0
-86.1485,39.7805,243,0,0,243,1,243,1,0,0,3,0,0,3,1,3,1,0,0
-86.148,39.7695,110,0,0,109,0.990909091,109,0.990909091,1,0.009090909,4,0,0,3,0.75,3,0.75,1,0.25
-86.148,39.771,548,0,0,546,0.996350365,546,0.996350365,2,0.003649635,20,0,0,18,0.9,18,0.9,2,0.1
-86.148,39.7735,2024,0,0,2020,0.998023715,2020,0.998023715,4,0.001976285,15,0,0,14,0.933333333,14,0.933333333,1,0.066666667
-86.148,39.7775,1172,0,0,1167,0.995733788,1167,0.995733788,5,0.004266212,6,0,0,5,0.833333333,5,0.833333333,1,0.166666667
-86.148,39.7805,127,0,0,123,0.968503937,123,0.968503937,4,0.031496063,5,0,0,4,0.8,4,0.8,1,0.2
-86.1475,39.7695,98,0,0,98,1,98,1,0,0,3,0,0,3,1,3,1,0,0
-86.1475,39.771,534,0,0,480,0.898876404,480,0.898876404,54,0.101123596,28,0,0,19,0.678571429,19,0.678571429,9,0.321428571
-86.1475,39.7735,579,0,0,575,0.993091537,575,0.993091537,4,0.006908463,12,0,0,10,0.833333333,10,0.833333333,2,0.166666667
-86.1475,39.7755,198,0,0,186,0.939393939,186,0.939393939,12,0.060606061,9,0,0,7,0.777777778,7,0.777777778,2,0.222222222
-86.1475,39.7775,262,0,0,250,0.954198473,250,0.954198473,12,0.045801527,8,0,0,6,0.75,6,0.75,2,0.25
-86.1475,39.7805,122,0,0,122,1,122,1,0,0,3,0,0,3,1,3,1,0,0
-86.147,39.7675,95,0,0,91,0.957894737,91,0.957894737,4,0.042105263,3,0,0,2,0.666666667,2,0.666666667,1,0.333333333
-86.147,39.768,481,0,0,481,1,481,1,0,0,4,0,0,4,1,4,1,0,0
-86.147,39.7685,357,0,0,350,0.980392157,350,0.980392157,7,0.019607843,5,0,0,4,0.8,4,0.8,1,0.2
-86.147,39.769,81,0,0,81,1,81,1,0,0,1,0,0,1,1,1,1,0,0
-86.147,39.7695,166,0,0,166,1,166,1,0,0,3,0,0,3,1,3,1,0,0
-86.147,39.771,671,0,0,558,0.831594635,558,0.831594635,113,0.168405365,50,0,0,30,0.6,30,0.6,20,0.4
-86.147,39.7715,105,0,0,104,0.99047619,104,0.99047619,1,0.00952381,4,0,0,3,0.75,3,0.75,1,0.25
-86.147,39.772,115,0,0,115,1,115,1,0,0,2,0,0,2,1,2,1,0,0
-86.147,39.7725,273,0,0,264,0.967032967,264,0.967032967,9,0.032967033,6,0,0,4,0.666666667,4,0.666666667,2,0.333333333
-86.147,39.7735,1187,0,0,1145,0.964616681,1145,0.964616681,42,0.035383319,26,0,0,18,0.692307692,18,0.692307692,8,0.307692308
-86.147,39.775,436,0,0,432,0.990825688,432,0.990825688,4,0.009174312,6,0,0,4,0.666666667,4,0.666666667,2,0.333333333
-86.147,39.7775,324,0,0,324,1,324,1,0,0,5,0,0,5,1,5,1,0,0
-86.147,39.7805,125,0,0,125,1,125,1,0,0,3,0,0,3,1,3,1,0,0
-86.1465,39.768,297,0,0,293,0.986531987,293,0.986531987,4,0.013468013,4,0,0,3,0.75,3,0.75,1,0.25
-86.1465,39.7695,67,0,0,67,1,67,1,0,0,2,0,0,2,1,2,1,0,0
-86.1465,39.771,528,0,0,507,0.960227273,507,0.960227273,21,0.039772727,23,0,0,17,0.739130435,17,0.739130435,6,0.260869565
-86.1465,39.7735,421,0,0,390,0.926365796,390,0.926365796,31,0.073634204,22,0,0,16,0.727272727,16,0.727272727,6,0.272727273
-86.1465,39.775,193,0,0,188,0.974093264,188,0.974093264,5,0.025906736,5,0,0,4,0.8,4,0.8,1,0.2
-86.1465,39.7755,67,0,0,67,1,67,1,0,0,1,0,0,1,1,1,1,0,0
-86.1465,39.776,120,0,0,117,0.975,117,0.975,3,0.025,5,0,0,4,0.8,4,0.8,1,0.2
-86.1465,39.7765,300,0,0,289,0.963333333,289,0.963333333,11,0.036666667,9,0,0,6,0.666666667,6,0.666666667,3,0.333333333
-86.1465,39.7775,332,0,0,318,0.957831325,318,0.957831325,14,0.042168675,13,0,0,9,0.692307692,9,0.692307692,4,0.307692308
-86.1465,39.7805,130,0,0,130,1,130,1,0,0,3,0,0,3,1,3,1,0,0
-86.146,39.7695,71,0,0,71,1,71,1,0,0,2,0,0,2,1,2,1,0,0
-86.146,39.771,532,0,0,502,0.943609023,502,0.943609023,30,0.056390977,22,0,0,15,0.681818182,15,0.681818182,7,0.318181818
-86.146,39.7735,427,0,0,397,0.929742389,397,0.929742389,30,0.070257611,27,0,0,20,0.740740741,20,0.740740741,7,0.259259259
-86.146,39.775,143,0,0,143,1,143,1,0,0,2,0,0,2,1,2,1,0,0
-86.146,39.7765,139,0,0,139,1,139,1,0,0,3,0,0,3,1,3,1,0,0
-86.146,39.7775,445,0,0,442,0.993258427,442,0.993258427,3,0.006741573,8,0,0,7,0.875,7,0.875,1,0.125
-86.146,39.7805,223,0,0,223,1,223,1,0,0,5,0,0,5,1,5,1,0,0
-86.1455,39.761,250,0,0,250,1,250,1,0,0,1,0,0,1,1,1,1,0,0
-86.1455,39.7615,81,0,0,81,1,81,1,0,0,1,0,0,1,1,1,1,0,0
-86.1455,39.762,81,0,0,81,1,81,1,0,0,1,0,0,1,1,1,1,0,0
-86.1455,39.7625,76,0,0,76,1,76,1,0,0,1,0,0,1,1,1,1,0,0
-86.1455,39.763,75,0,0,75,1,75,1,0,0,1,0,0,1,1,1,1,0,0
-86.1455,39.7635,84,0,0,84,1,84,1,0,0,1,0,0,1,1,1,1,0,0
-86.1455,39.764,83,0,0,83,1,83,1,0,0,1,0,0,1,1,1,1,0,0
-86.1455,39.7645,60,0,0,60,1,60,1,0,0,1,0,0,1,1,1,1,0,0
-86.1455,39.7665,532,0,0,532,1,532,1,0,0,1,0,0,1,1,1,1,0,0
-86.1455,39.767,59,0,0,59,1,59,1,0,0,2,0,0,2,1,2,1,0,0
-86.1455,39.768,630,0,0,609,0.966666667,609,0.966666667,21,0.033333333,12,0,0,7,0.583333333,7,0.583333333,5,0.416666667
-86.1455,39.7685,387,0,0,375,0.968992248,375,0.968992248,12,0.031007752,6,0,0,4,0.666666667,4,0.666666667,2,0.333333333
-86.1455,39.769,1965,0,0,1934,0.984223919,1934,0.984223919,31,0.015776081,14,0,0,8,0.571428571,8,0.571428571,6,0.428571429
-86.1455,39.7695,352,0,0,338,0.960227273,338,0.960227273,14,0.039772727,10,0,0,7,0.7,7,0.7,3,0.3
-86.1455,39.77,170,0,0,170,1,170,1,0,0,2,0,0,2,1,2,1,0,0
-86.1455,39.771,1359,0,0,1319,0.970566593,1319,0.970566593,40,0.029433407,32,0,0,22,0.6875,22,0.6875,10,0.3125
-86.1455,39.7715,70,0,0,70,1,70,1,0,0,3,0,0,3,1,3,1,0,0
-86.1455,39.7735,589,0,0,580,0.984719864,580,0.984719864,9,0.015280136,14,0,0,12,0.857142857,12,0.857142857,2,0.142857143
-86.1455,39.775,198,0,0,198,1,198,1,0,0,2,0,0,2,1,2,1,0,0
-86.1455,39.777,826,0,0,815,0.986682809,815,0.986682809,11,0.013317191,9,0,0,6,0.666666667,6,0.666666667,3,0.333333333
-86.1455,39.7775,635,0,0,627,0.987401575,627,0.987401575,8,0.012598425,10,0,0,8,0.8,8,0.8,2,0.2
-86.1455,39.7805,160,0,0,160,1,160,1,0,0,5,0,0,5,1,5,1,0,0
-86.145,39.7695,439,0,0,427,0.972665148,427,0.972665148,12,0.027334852,6,0,0,4,0.666666667,4,0.666666667,2,0.333333333
-86.145,39.7705,271,0,0,271,1,271,1,0,0,2,0,0,2,1,2,1,0,0
-86.145,39.771,675,0,0,675,1,675,1,0,0,5,0,0,5,1,5,1,0,0
-86.145,39.7715,866,0,0,862,0.995381062,862,0.995381062,4,0.004618938,9,0,0,8,0.888888889,8,0.888888889,1,0.111111111
-86.145,39.772,1938,0,0,1880,0.970072239,1880,0.970072239,58,0.029927761,37,0,0,24,0.648648649,24,0.648648649,13,0.351351351
-86.145,39.7725,762,0,0,745,0.977690289,745,0.977690289,17,0.022309711,20,0,0,14,0.7,14,0.7,6,0.3
-86.145,39.773,2623,0,0,2506,0.955394586,2506,0.955394586,117,0.044605414,12,0,0,10,0.833333333,10,0.833333333,2,0.166666667
-86.145,39.7735,2953,0,0,2909,0.985099898,2909,0.985099898,44,0.014900102,31,0,0,22,0.709677419,22,0.709677419,9,0.290322581
-86.145,39.774,167,0,0,159,0.952095808,159,0.952095808,8,0.047904192,7,0,0,5,0.714285714,5,0.714285714,2,0.285714286
-86.145,39.775,1104,0,0,1072,0.971014493,1072,0.971014493,32,0.028985507,19,0,0,13,0.684210526,13,0.684210526,6,0.315789474
-86.145,39.7755,289,0,0,285,0.98615917,285,0.98615917,4,0.01384083,9,0,0,8,0.888888889,8,0.888888889,1,0.111111111
-86.145,39.776,292,0,0,292,1,292,1,0,0,6,0,0,6,1,6,1,0,0
-86.145,39.7765,382,0,0,382,1,382,1,0,0,6,0,0,6,1,6,1,0,0
-86.145,39.777,1521,0,0,1521,1,1521,1,0,0,7,0,0,7,1,7,1,0,0
-86.145,39.7775,1571,0,0,1571,1,1571,1,0,0,9,0,0,9,1,9,1,0,0
-86.145,39.778,263,0,0,263,1,263,1,0,0,4,0,0,4,1,4,1,0,0
-86.145,39.7785,439,0,0,439,1,439,1,0,0,4,0,0,4,1,4,1,0,0
-86.145,39.779,699,0,0,699,1,699,1,0,0,4,0,0,4,1,4,1,0,0
-86.145,39.7795,399,0,0,399,1,399,1,0,0,6,0,0,6,1,6,1,0,0
-86.145,39.78,1145,0,0,1126,0.983406114,1126,0.983406114,19,0.016593886,14,0,0,10,0.714285714,10,0.714285714,4,0.285714286
-86.145,39.7805,691,0,0,679,0.982633864,679,0.982633864,12,0.017366136,10,0,0,7,0.7,7,0.7,3,0.3