grid_lat,grid_lon,total_sample,mw_sample,mw_ratio,sub6_sample,sub6_ratio,5g_sample,5g_sample,lte_sample,lte_ratio,total_cs_sample,mw_cs_sample,mw_cs_ratio,sub6_cs_sample,sub6_cs_ratio,5g_cs_sample,5g_cs_sample,lte_cs_sample,lte_cs_ratio
-86.1675,39.761,3010,0,0.0,179,0.05946843853820598,179,0.05946843853820598,2831,0.9405315614617941,7,0,0.0,4,0.5714285714285714,4,0.5714285714285714,3,0.42857142857142855
-86.1675,39.7615,84,0,0.0,35,0.4166666666666667,35,0.4166666666666667,49,0.5833333333333334,5,0,0.0,3,0.6,3,0.6,2,0.4
-86.1675,39.7655,387,0,0.0,387,1.0,387,1.0,0,0.0,2,0,0.0,2,1.0,2,1.0,0,0.0
-86.1675,39.767,49,0,0.0,49,1.0,49,1.0,0,0.0,1,0,0.0,1,1.0,1,1.0,0,0.0
-86.1675,39.771,11,0,0.0,0,0.0,0,0.0,11,1.0,1,0,0.0,0,0.0,0,0.0,1,1.0
-86.1675,39.7715,87,0,0.0,0,0.0,0,0.0,87,1.0,1,0,0.0,0,0.0,0,0.0,1,1.0
-86.1675,39.7725,24,0,0.0,24,1.0,24,1.0,0,0.0,1,0,0.0,1,1.0,1,1.0,0,0.0
-86.1675,39.773,11,0,0.0,11,1.0,11,1.0,0,0.0,1,0,0.0,1,1.0,1,1.0,0,0.0
-86.1675,39.774,231,0,0.0,215,0.9307359307359307,215,0.9307359307359307,16,0.06926406926406926,7,0,0.0,6,0.8571428571428571,6,0.8571428571428571,1,0.14285714285714285
-86.1675,39.776,36,0,0.0,36,1.0,36,1.0,0,0.0,1,0,0.0,1,1.0,1,1.0,0,0.0
-86.1675,39.7775,83,0,0.0,77,0.927710843373494,77,0.927710843373494,6,0.07228915662650602,14,0,0.0,11,0.7857142857142857,11,0.7857142857142857,3,0.21428571428571427
-86.1675,39.778,714,0,0.0,672,0.9411764705882353,672,0.9411764705882353,42,0.058823529411764705,24,0,0.0,20,0.8333333333333334,20,0.8333333333333334,4,0.16666666666666666
-86.1675,39.7785,731,0,0.0,676,0.9247606019151847,676,0.9247606019151847,55,0.07523939808481532,33,0,0.0,24,0.7272727272727273,24,0.7272727272727273,9,0.2727272727272727
-86.1675,39.779,694,0,0.0,622,0.8962536023054755,622,0.8962536023054755,72,0.1037463976945245,18,0,0.0,16,0.8888888888888888,16,0.8888888888888888,2,0.1111111111111111
-86.1675,39.7795,642,0,0.0,601,0.9361370716510904,601,0.9361370716510904,41,0.06386292834890965,24,0,0.0,18,0.75,18,0.75,6,0.25
-86.1675,39.78,650,0,0.0,548,0.8430769230769231,548,0.8430769230769231,102,0.15692307692307692,26,0,0.0,15,0.5769230769230769,15,0.5769230769230769,11,0.4230769230769231
-86.1675,39.7805,1189,0,0.0,370,0.31118587047939444,370,0.31118587047939444,819,0.6888141295206055,45,0,0.0,18,0.4,18,0.4,27,0.6
-86.167,39.761,1531,0,0.0,555,0.36250816459830176,555,0.36250816459830176,976,0.6374918354016982,30,0,0.0,13,0.43333333333333335,13,0.43333333333333335,17,0.5666666666666667
-86.167,39.7615,8389,0,0.0,4674,0.5571581833353201,4674,0.5571581833353201,3715,0.4428418166646799,46,0,0.0,21,0.45652173913043476,21,0.45652173913043476,25,0.5434782608695652
-86.167,39.762,487,0,0.0,312,0.6406570841889117,312,0.6406570841889117,175,0.3593429158110883,19,0,0.0,10,0.5263157894736842,10,0.5263157894736842,9,0.47368421052631576
-86.167,39.7625,409,0,0.0,256,0.6259168704156479,256,0.6259168704156479,153,0.3740831295843521,17,0,0.0,10,0.5882352941176471,10,0.5882352941176471,7,0.4117647058823529
-86.167,39.763,385,0,0.0,212,0.5506493506493506,212,0.5506493506493506,173,0.44935064935064933,18,0,0.0,9,0.5,9,0.5,9,0.5
-86.167,39.7635,377,0,0.0,176,0.46684350132625996,176,0.46684350132625996,201,0.53315649867374,15,0,0.0,7,0.4666666666666667,7,0.4666666666666667,8,0.5333333333333333
-86.167,39.764,2956,0,0.0,1130,0.38227334235453314,1130,0.38227334235453314,1826,0.6177266576454669,35,0,0.0,11,0.3142857142857143,11,0.3142857142857143,24,0.6857142857142857
-86.167,39.7645,321,0,0.0,224,0.6978193146417445,224,0.6978193146417445,97,0.30218068535825543,13,0,0.0,8,0.6153846153846154,8,0.6153846153846154,5,0.38461538461538464
-86.167,39.765,913,0,0.0,803,0.8795180722891566,803,0.8795180722891566,110,0.12048192771084337,23,0,0.0,12,0.5217391304347826,12,0.5217391304347826,11,0.4782608695652174
-86.167,39.7655,1473,0,0.0,627,0.4256619144602851,627,0.4256619144602851,846,0.5743380855397149,14,0,0.0,6,0.42857142857142855,6,0.42857142857142855,8,0.5714285714285714
-86.167,39.766,1599,0,0.0,345,0.21575984990619138,345,0.21575984990619138,1254,0.7842401500938087,22,0,0.0,6,0.2727272727272727,6,0.2727272727272727,16,0.7272727272727273
-86.167,39.7665,429,0,0.0,219,0.5104895104895105,219,0.5104895104895105,210,0.48951048951048953,8,0,0.0,4,0.5,4,0.5,4,0.5
-86.167,39.767,474,0,0.0,220,0.4641350210970464,220,0.4641350210970464,254,0.5358649789029536,13,0,0.0,7,0.5384615384615384,7,0.5384615384615384,6,0.46153846153846156
-86.167,39.7675,499,0,0.0,378,0.7575150300601202,378,0.7575150300601202,121,0.24248496993987975,12,0,0.0,6,0.5,6,0.5,6,0.5
-86.167,39.768,181,0,0.0,0,0.0,0,0.0,181,1.0,5,0,0.0,0,0.0,0,0.0,5,1.0
-86.167,39.7685,118,0,0.0,0,0.0,0,0.0,118,1.0,3,0,0.0,0,0.0,0,0.0,3,1.0
-86.167,39.769,109,0,0.0,0,0.0,0,0.0,109,1.0,3,0,0.0,0,0.0,0,0.0,3,1.0
-86.167,39.7695,196,0,0.0,0,0.0,0,0.0,196,1.0,2,0,0.0,0,0.0,0,0.0,2,1.0
-86.167,39.77,328,0,0.0,0,0.0,0,0.0,328,1.0,5,0,0.0,0,0.0,0,0.0,5,1.0
-86.167,39.7705,190,0,0.0,0,0.0,0,0.0,190,1.0,4,0,0.0,0,0.0,0,0.0,4,1.0
-86.167,39.771,329,0,0.0,0,0.0,0,0.0,329,1.0,3,0,0.0,0,0.0,0,0.0,3,1.0
-86.167,39.7715,937,0,0.0,0,0.0,0,0.0,937,1.0,6,0,0.0,0,0.0,0,0.0,6,1.0
-86.167,39.772,159,0,0.0,0,0.0,0,0.0,159,1.0,6,0,0.0,0,0.0,0,0.0,6,1.0
-86.167,39.7725,151,0,0.0,45,0.2980132450331126,45,0.2980132450331126,106,0.7019867549668874,4,0,0.0,1,0.25,1,0.25,3,0.75
-86.167,39.773,267,0,0.0,104,0.3895131086142322,104,0.3895131086142322,163,0.6104868913857678,4,0,0.0,2,0.5,2,0.5,2,0.5
-86.167,39.7735,39,0,0.0,39,1.0,39,1.0,0,0.0,1,0,0.0,1,1.0,1,1.0,0,0.0
-86.167,39.774,673,0,0.0,670,0.9955423476968797,670,0.9955423476968797,3,0.004457652303120356,7,0,0.0,6,0.8571428571428571,6,0.8571428571428571,1,0.14285714285714285
-86.167,39.7755,25,0,0.0,25,1.0,25,1.0,0,0.0,1,0,0.0,1,1.0,1,1.0,0,0.0
-86.167,39.776,83,0,0.0,83,1.0,83,1.0,0,0.0,3,0,0.0,3,1.0,3,1.0,0,0.0
-86.167,39.7765,397,0,0.0,397,1.0,397,1.0,0,0.0,11,0,0.0,11,1.0,11,1.0,0,0.0
-86.167,39.777,747,0,0.0,747,1.0,747,1.0,0,0.0,19,0,0.0,19,1.0,19,1.0,0,0.0
-86.167,39.7775,973,0,0.0,940,0.9660842754367934,940,0.9660842754367934,33,0.03391572456320658,32,0,0.0,25,0.78125,25,0.78125,7,0.21875
-86.167,39.778,2267,0,0.0,2267,1.0,2267,1.0,0,0.0,13,0,0.0,13,1.0,13,1.0,0,0.0
-86.167,39.7785,12,0,0.0,12,1.0,12,1.0,0,0.0,4,0,0.0,4,1.0,4,1.0,0,0.0
-86.167,39.7805,40,0,0.0,0,0.0,0,0.0,40,1.0,1,0,0.0,0,0.0,0,0.0,1,1.0
-86.1665,39.761,89,0,0.0,89,1.0,89,1.0,0,0.0,1,0,0.0,1,1.0,1,1.0,0,0.0
-86.1665,39.7615,2461,0,0.0,1016,0.41284030881755385,1016,0.41284030881755385,1445,0.5871596911824462,23,0,0.0,11,0.4782608695652174,11,0.4782608695652174,12,0.5217391304347826
-86.1665,39.7625,3,0,0.0,3,1.0,3,1.0,0,0.0,1,0,0.0,1,1.0,1,1.0,0,0.0
-86.1665,39.763,3,0,0.0,3,1.0,3,1.0,0,0.0,1,0,0.0,1,1.0,1,1.0,0,0.0
-86.1665,39.7635,435,0,0.0,177,0.4068965517241379,177,0.4068965517241379,258,0.593103448275862,17,0,0.0,8,0.47058823529411764,8,0.47058823529411764,9,0.5294117647058824
-86.1665,39.764,317,0,0.0,133,0.4195583596214511,133,0.4195583596214511,184,0.580441640378549,12,0,0.0,6,0.5,6,0.5,6,0.5
-86.1665,39.7645,9,0,0.0,0,0.0,0,0.0,9,1.0,1,0,0.0,0,0.0,0,0.0,1,1.0
-86.1665,39.765,174,0,0.0,174,1.0,174,1.0,0,0.0,1,0,0.0,1,1.0,1,1.0,0,0.0
-86.1665,39.7655,211,0,0.0,50,0.23696682464454977,50,0.23696682464454977,161,0.7630331753554502,4,0,0.0,2,0.5,2,0.5,2,0.5
-86.1665,39.766,40,0,0.0,40,1.0,40,1.0,0,0.0,1,0,0.0,1,1.0,1,1.0,0,0.0
-86.1665,39.7665,64,0,0.0,64,1.0,64,1.0,0,0.0,2,0,0.0,2,1.0,2,1.0,0,0.0
-86.1665,39.767,2552,0,0.0,1529,0.5991379310344828,1529,0.5991379310344828,1023,0.40086206896551724,55,0,0.0,34,0.6181818181818182,34,0.6181818181818182,21,0.38181818181818183
-86.1665,39.7675,765,0,0.0,627,0.8196078431372549,627,0.8196078431372549,138,0.1803921568627451,30,0,0.0,18,0.6,18,0.6,12,0.4
-86.1665,39.768,1080,0,0.0,143,0.13240740740740742,143,0.13240740740740742,937,0.8675925925925926,19,0,0.0,6,0.3157894736842105,6,0.3157894736842105,13,0.6842105263157895
-86.1665,39.7685,829,0,0.0,112,0.13510253317249699,112,0.13510253317249699,717,0.864897466827503,14,0,0.0,3,0.21428571428571427,3,0.21428571428571427,11,0.7857142857142857
-86.1665,39.769,839,0,0.0,95,0.11323003575685339,95,0.11323003575685339,744,0.8867699642431466,36,0,0.0,4,0.1111111111111111,4,0.1111111111111111,32,0.8888888888888888
-86.1665,39.7695,2245,0,0.0,334,0.1487750556792873,334,0.1487750556792873,1911,0.8512249443207127,23,0,0.0,3,0.13043478260869565,3,0.13043478260869565,20,0.8695652173913043
-86.1665,39.77,3456,0,0.0,80,0.023148148148148147,80,0.023148148148148147,3376,0.9768518518518519,39,0,0.0,2,0.05128205128205128,2,0.05128205128205128,37,0.9487179487179487
-86.1665,39.7705,1317,0,0.0,47,0.03568716780561883,47,0.03568716780561883,1270,0.9643128321943811,28,0,0.0,1,0.03571428571428571,1,0.03571428571428571,27,0.9642857142857143
-86.1665,39.771,4141,0,0.0,58,0.014006278676648153,58,0.014006278676648153,4083,0.9859937213233518,19,0,0.0,1,0.05263157894736842,1,0.05263157894736842,18,0.9473684210526315
-86.1665,39.7715,12841,0,0.0,316,0.024608675336811776,316,0.024608675336811776,12525,0.9753913246631882,55,0,0.0,1,0.01818181818181818,1,0.01818181818181818,54,0.9818181818181818
-86.1665,39.772,2479,0,0.0,28,0.011294876966518758,28,0.011294876966518758,2451,0.9887051230334812,61,0,0.0,1,0.01639344262295082,1,0.01639344262295082,60,0.9836065573770492
-86.1665,39.7725,3768,0,0.0,606,0.160828025477707,606,0.160828025477707,3162,0.839171974522293,100,0,0.0,21,0.21,21,0.21,79,0.79
-86.1665,39.773,4687,0,0.0,3523,0.7516535097077022,3523,0.7516535097077022,1164,0.24834649029229786,97,0,0.0,44,0.4536082474226804,44,0.4536082474226804,53,0.5463917525773195
-86.1665,39.7735,2485,0,0.0,2276,0.9158953722334005,2276,0.9158953722334005,209,0.0841046277665996,78,0,0.0,51,0.6538461538461539,51,0.6538461538461539,27,0.34615384615384615
-86.1665,39.774,8625,0,0.0,5359,0.6213333333333333,5359,0.6213333333333333,3266,0.37866666666666665,67,0,0.0,48,0.7164179104477612,48,0.7164179104477612,19,0.2835820895522388
-86.1665,39.7745,4067,0,0.0,4027,0.9901647405950332,4027,0.9901647405950332,40,0.009835259404966806,28,0,0.0,24,0.8571428571428571,24,0.8571428571428571,4,0.14285714285714285
-86.1665,39.775,3167,0,0.0,3134,0.9895800442058731,3134,0.9895800442058731,33,0.010419955794126934,28,0,0.0,24,0.8571428571428571,24,0.8571428571428571,4,0.14285714285714285
-86.1665,39.7755,2788,0,0.0,2077,0.7449784791965567,2077,0.7449784791965567,711,0.2550215208034433,89,0,0.0,54,0.6067415730337079,54,0.6067415730337079,35,0.39325842696629215
-86.1665,39.776,1297,0,0.0,1289,0.9938319198149576,1289,0.9938319198149576,8,0.006168080185042405,23,0,0.0,21,0.9130434782608695,21,0.9130434782608695,2,0.08695652173913043
-86.1665,39.7765,684,0,0.0,684,1.0,684,1.0,0,0.0,18,0,0.0,18,1.0,18,1.0,0,0.0
-86.1665,39.777,231,0,0.0,231,1.0,231,1.0,0,0.0,9,0,0.0,9,1.0,9,1.0,0,0.0
-86.1665,39.778,316,0,0.0,316,1.0,316,1.0,0,0.0,8,0,0.0,8,1.0,8,1.0,0,0.0
-86.1665,39.7805,36,0,0.0,10,0.2777777777777778,10,0.2777777777777778,26,0.7222222222222222,3,0,0.0,1,0.3333333333333333,1,0.3333333333333333,2,0.6666666666666666
-86.166,39.7615,1017,0,0.0,339,0.3333333333333333,339,0.3333333333333333,678,0.6666666666666666,15,0,0.0,7,0.4666666666666667,7,0.4666666666666667,8,0.5333333333333333
-86.166,39.7625,35,0,0.0,21,0.6,21,0.6,14,0.4,7,0,0.0,3,0.42857142857142855,3,0.42857142857142855,4,0.5714285714285714
-86.166,39.763,481,0,0.0,165,0.34303534303534305,165,0.34303534303534305,316,0.656964656964657,21,0,0.0,8,0.38095238095238093,8,0.38095238095238093,13,0.6190476190476191
-86.166,39.7635,87,0,0.0,50,0.5747126436781609,50,0.5747126436781609,37,0.42528735632183906,13,0,0.0,5,0.38461538461538464,5,0.38461538461538464,8,0.6153846153846154
-86.166,39.764,3,0,0.0,3,1.0,3,1.0,0,0.0,1,0,0.0,1,1.0,1,1.0,0,0.0
-86.166,39.7645,1,0,0.0,1,1.0,1,1.0,0,0.0,1,0,0.0,1,1.0,1,1.0,0,0.0
-86.166,39.7655,189,0,0.0,40,0.21164021164021163,40,0.21164021164021163,149,0.7883597883597884,3,0,0.0,1,0.3333333333333333,1,0.3333333333333333,2,0.6666666666666666
-86.166,39.7665,16,0,0.0,16,1.0,16,1.0,0,0.0,1,0,0.0,1,1.0,1,1.0,0,0.0
-86.166,39.767,1156,0,0.0,974,0.842560553633218,974,0.842560553633218,182,0.157439446366782,19,0,0.0,16,0.8421052631578947,16,0.8421052631578947,3,0.15789473684210525
-86.166,39.7675,23,0,0.0,23,1.0,23,1.0,0,0.0,1,0,0.0,1,1.0,1,1.0,0,0.0
-86.166,39.77,855,0,0.0,193,0.22573099415204678,193,0.22573099415204678,662,0.7742690058479532,51,0,0.0,14,0.27450980392156865,14,0.27450980392156865,37,0.7254901960784313
-86.166,39.771,397,0,0.0,0,0.0,0,0.0,397,1.0,8,0,0.0,0,0.0,0,0.0,8,1.0
-86.166,39.7715,400,0,0.0,0,0.0,0,0.0,400,1.0,6,0,0.0,0,0.0,0,0.0,6,1.0
-86.166,39.774,5773,0,0.0,5345,0.9258617703100641,5345,0.9258617703100641,428,0.07413822968993591,46,0,0.0,21,0.45652173913043476,21,0.45652173913043476,25,0.5434782608695652
-86.166,39.7745,1,0,0.0,1,1.0,1,1.0,0,0.0,1,0,0.0,1,1.0,1,1.0,0,0.0
-86.166,39.775,148,0,0.0,144,0.972972972972973,144,0.972972972972973,4,0.02702702702702703,3,0,0.0,2,0.6666666666666666,2,0.6666666666666666,1,0.3333333333333333
-86.166,39.778,733,0,0.0,733,1.0,733,1.0,0,0.0,8,0,0.0,8,1.0,8,1.0,0,0.0
-86.166,39.7805,34,0,0.0,28,0.8235294117647058,28,0.8235294117647058,6,0.17647058823529413,3,0,0.0,2,0.6666666666666666,2,0.6666666666666666,1,0.3333333333333333
-86.1655,39.761,4246,0,0.0,723,0.17027790861987754,723,0.17027790861987754,3523,0.8297220913801224,47,0,0.0,11,0.23404255319148937,11,0.23404255319148937,36,0.7659574468085106
-86.1655,39.7615,2870,0,0.0,1597,0.5564459930313589,1597,0.5564459930313589,1273,0.4435540069686411,41,0,0.0,17,0.4146341463414634,17,0.4146341463414634,24,0.5853658536585366
-86.1655,39.762,535,0,0.0,241,0.4504672897196262,241,0.4504672897196262,294,0.5495327102803739,13,0,0.0,7,0.5384615384615384,7,0.5384615384615384,6,0.46153846153846156
-86.1655,39.7625,481,0,0.0,245,0.5093555093555093,245,0.5093555093555093,236,0.49064449064449067,18,0,0.0,9,0.5,9,0.5,9,0.5
-86.1655,39.763,35,0,0.0,31,0.8857142857142857,31,0.8857142857142857,4,0.11428571428571428,4,0,0.0,3,0.75,3,0.75,1,0.25
-86.1655,39.7645,3,0,0.0,3,1.0,3,1.0,0,0.0,1,0,0.0,1,1.0,1,1.0,0,0.0
-86.1655,39.765,3,0,0.0,3,1.0,3,1.0,0,0.0,1,0,0.0,1,1.0,1,1.0,0,0.0
-86.1655,39.7655,293,0,0.0,37,0.12627986348122866,37,0.12627986348122866,256,0.8737201365187713,11,0,0.0,2,0.18181818181818182,2,0.18181818181818182,9,0.8181818181818182
-86.1655,39.767,668,0,0.0,516,0.7724550898203593,516,0.7724550898203593,152,0.2275449101796407,14,0,0.0,12,0.8571428571428571,12,0.8571428571428571,2,0.14285714285714285
-86.1655,39.77,747,0,0.0,423,0.5662650602409639,423,0.5662650602409639,324,0.43373493975903615,35,0,0.0,17,0.4857142857142857,17,0.4857142857142857,18,0.5142857142857142
-86.1655,39.771,417,0,0.0,0,0.0,0,0.0,417,1.0,8,0,0.0,0,0.0,0,0.0,8,1.0
-86.1655,39.7715,303,0,0.0,0,0.0,0,0.0,303,1.0,5,0,0.0,0,0.0,0,0.0,5,1.0
-86.1655,39.774,899,0,0.0,183,0.203559510567297,183,0.203559510567297,716,0.796440489432703,42,0,0.0,14,0.3333333333333333,14,0.3333333333333333,28,0.6666666666666666
-86.1655,39.7745,115,0,0.0,48,0.41739130434782606,48,0.41739130434782606,67,0.5826086956521739,4,0,0.0,2,0.5,2,0.5,2,0.5
-86.1655,39.775,15,0,0.0,11,0.7333333333333333,11,0.7333333333333333,4,0.26666666666666666,2,0,0.0,1,0.5,1,0.5,1,0.5
-86.1655,39.778,340,0,0.0,340,1.0,340,1.0,0,0.0,8,0,0.0,8,1.0,8,1.0,0,0.0
-86.1655,39.7805,29,0,0.0,29,1.0,29,1.0,0,0.0,1,0,0.0,1,1.0,1,1.0,0,0.0
-86.165,39.761,204,0,0.0,0,0.0,0,0.0,204,1.0,1,0,0.0,0,0.0,0,0.0,1,1.0
-86.165,39.7615,2660,0,0.0,941,0.3537593984962406,941,0.3537593984962406,1719,0.6462406015037594,24,0,0.0,10,0.4166666666666667,10,0.4166666666666667,14,0.5833333333333334
-86.165,39.7655,173,0,0.0,41,0.23699421965317918,41,0.23699421965317918,132,0.7630057803468208,3,0,0.0,2,0.6666666666666666,2,0.6666666666666666,1,0.3333333333333333
-86.165,39.766,3,0,0.0,3,1.0,3,1.0,0,0.0,1,0,0.0,1,1.0,1,1.0,0,0.0
-86.165,39.767,1874,0,0.0,1721,0.9183564567769477,1721,0.9183564567769477,153,0.0816435432230523,22,0,0.0,19,0.8636363636363636,19,0.8636363636363636,3,0.13636363636363635
-86.165,39.77,611,0,0.0,232,0.37970540098199673,232,0.37970540098199673,379,0.6202945990180033,30,0,0.0,13,0.43333333333333335,13,0.43333333333333335,17,0.5666666666666667
-86.165,39.771,511,0,0.0,5,0.009784735812133072,5,0.009784735812133072,506,0.9902152641878669,36,0,0.0,1,0.027777777777777776,1,0.027777777777777776,35,0.9722222222222222
-86.165,39.7715,225,0,0.0,0,0.0,0,0.0,225,1.0,10,0,0.0,0,0.0,0,0.0,10,1.0
-86.165,39.774,934,0,0.0,198,0.21199143468950749,198,0.21199143468950749,736,0.7880085653104925,14,0,0.0,5,0.35714285714285715,5,0.35714285714285715,9,0.6428571428571429
-86.165,39.7745,432,0,0.0,15,0.034722222222222224,15,0.034722222222222224,417,0.9652777777777778,2,0,0.0,1,0.5,1,0.5,1,0.5
-86.165,39.778,329,0,0.0,329,1.0,329,1.0,0,0.0,8,0,0.0,8,1.0,8,1.0,0,0.0
-86.165,39.7805,4,0,0.0,4,1.0,4,1.0,0,0.0,1,0,0.0,1,1.0,1,1.0,0,0.0
-86.1645,39.7615,549,0,0.0,193,0.35154826958105645,193,0.35154826958105645,356,0.6484517304189436,20,0,0.0,7,0.35,7,0.35,13,0.65
-86.1645,39.7655,151,0,0.0,38,0.25165562913907286,38,0.25165562913907286,113,0.7483443708609272,3,0,0.0,2,0.6666666666666666,2,0.6666666666666666,1,0.3333333333333333
-86.1645,39.766,1,0,0.0,1,1.0,1,1.0,0,0.0,1,0,0.0,1,1.0,1,1.0,0,0.0
-86.1645,39.7665,3,0,0.0,3,1.0,3,1.0,0,0.0,1,0,0.0,1,1.0,1,1.0,0,0.0
-86.1645,39.767,969,0,0.0,763,0.7874097007223942,763,0.7874097007223942,206,0.21259029927760578,27,0,0.0,21,0.7777777777777778,21,0.7777777777777778,6,0.2222222222222222
-86.1645,39.77,556,0,0.0,49,0.08812949640287769,49,0.08812949640287769,507,0.9118705035971223,14,0,0.0,1,0.07142857142857142,1,0.07142857142857142,13,0.9285714285714286
-86.1645,39.771,655,0,0.0,85,0.1297709923664122,85,0.1297709923664122,570,0.8702290076335878,20,0,0.0,5,0.25,5,0.25,15,0.75
-86.1645,39.7715,123,0,0.0,0,0.0,0,0.0,123,1.0,6,0,0.0,0,0.0,0,0.0,6,1.0
-86.1645,39.7735,86,0,0.0,22,0.2558139534883721,22,0.2558139534883721,64,0.7441860465116279,5,0,0.0,1,0.2,1,0.2,4,0.8
-86.1645,39.774,4093,0,0.0,565,0.1380405570486196,565,0.1380405570486196,3528,0.8619594429513804,14,0,0.0,4,0.2857142857142857,4,0.2857142857142857,10,0.7142857142857143
-86.1645,39.778,342,0,0.0,342,1.0,342,1.0,0,0.0,8,0,0.0,8,1.0,8,1.0,0,0.0
-86.164,39.7615,511,0,0.0,124,0.24266144814090018,124,0.24266144814090018,387,0.7573385518590998,16,0,0.0,2,0.125,2,0.125,14,0.875
-86.164,39.7655,150,0,0.0,38,0.25333333333333335,38,0.25333333333333335,112,0.7466666666666667,2,0,0.0,1,0.5,1,0.5,1,0.5
-86.164,39.767,748,0,0.0,593,0.7927807486631016,593,0.7927807486631016,155,0.2072192513368984,19,0,0.0,15,0.7894736842105263,15,0.7894736842105263,4,0.21052631578947367
-86.164,39.7695,760,0,0.0,0,0.0,0,0.0,760,1.0,3,0,0.0,0,0.0,0,0.0,3,1.0
-86.164,39.77,656,0,0.0,46,0.0701219512195122,46,0.0701219512195122,610,0.9298780487804879,19,0,0.0,2,0.10526315789473684,2,0.10526315789473684,17,0.8947368421052632
-86.164,39.771,806,0,0.0,119,0.14764267990074442,119,0.14764267990074442,687,0.8523573200992556,12,0,0.0,1,0.08333333333333333,1,0.08333333333333333,11,0.9166666666666666
-86.164,39.7715,291,0,0.0,0,0.0,0,0.0,291,1.0,2,0,0.0,0,0.0,0,0.0,2,1.0
-86.164,39.773,59,0,0.0,0,0.0,0,0.0,59,1.0,3,0,0.0,0,0.0,0,0.0,3,1.0
-86.164,39.7735,115,0,0.0,11,0.09565217391304348,11,0.09565217391304348,104,0.9043478260869565,5,0,0.0,1,0.2,1,0.2,4,0.8
-86.164,39.774,1240,0,0.0,166,0.1338709677419355,166,0.1338709677419355,1074,0.8661290322580645,15,0,0.0,5,0.3333333333333333,5,0.3333333333333333,10,0.6666666666666666
-86.164,39.778,364,0,0.0,364,1.0,364,1.0,0,0.0,8,0,0.0,8,1.0,8,1.0,0,0.0
-86.1635,39.7615,503,0,0.0,126,0.2504970178926441,126,0.2504970178926441,377,0.7495029821073559,21,0,0.0,5,0.23809523809523808,5,0.23809523809523808,16,0.7619047619047619
-86.1635,39.7655,148,0,0.0,27,0.18243243243243243,27,0.18243243243243243,121,0.8175675675675675,10,0,0.0,1,0.1,1,0.1,9,0.9
-86.1635,39.7665,3,0,0.0,0,0.0,0,0.0,3,1.0,1,0,0.0,0,0.0,0,0.0,1,1.0
-86.1635,39.767,842,0,0.0,653,0.7755344418052257,653,0.7755344418052257,189,0.22446555819477435,34,0,0.0,24,0.7058823529411765,24,0.7058823529411765,10,0.29411764705882354
-86.1635,39.7695,6503,0,0.0,357,0.05489773950484392,357,0.05489773950484392,6146,0.9451022604951561,24,0,0.0,4,0.16666666666666666,4,0.16666666666666666,20,0.8333333333333334
-86.1635,39.77,3615,0,0.0,429,0.11867219917012448,429,0.11867219917012448,3186,0.8813278008298755,37,0,0.0,2,0.05405405405405406,2,0.05405405405405406,35,0.9459459459459459
-86.1635,39.771,3086,0,0.0,400,0.12961762799740764,400,0.12961762799740764,2686,0.8703823720025924,12,0,0.0,1,0.08333333333333333,1,0.08333333333333333,11,0.9166666666666666
-86.1635,39.7715,224,0,0.0,186,0.8303571428571429,186,0.8303571428571429,38,0.16964285714285715,3,0,0.0,1,0.3333333333333333,1,0.3333333333333333,2,0.6666666666666666
-86.1635,39.7725,41,0,0.0,0,0.0,0,0.0,41,1.0,3,0,0.0,0,0.0,0,0.0,3,1.0
-86.1635,39.773,473,0,0.0,0,0.0,0,0.0,473,1.0,3,0,0.0,0,0.0,0,0.0,3,1.0
-86.1635,39.774,797,0,0.0,171,0.21455457967377667,171,0.21455457967377667,626,0.7854454203262233,13,0,0.0,5,0.38461538461538464,5,0.38461538461538464,8,0.6153846153846154
-86.1635,39.7755,817,0,0.0,817,1.0,817,1.0,0,0.0,2,0,0.0,2,1.0,2,1.0,0,0.0
-86.1635,39.776,48,0,0.0,48,1.0,48,1.0,0,0.0,1,0,0.0,1,1.0,1,1.0,0,0.0
-86.1635,39.778,976,0,0.0,976,1.0,976,1.0,0,0.0,10,0,0.0,10,1.0,10,1.0,0,0.0
-86.1635,39.7785,4,0,0.0,4,1.0,4,1.0,0,0.0,1,0,0.0,1,1.0,1,1.0,0,0.0
-86.163,39.7615,2312,0,0.0,33,0.014273356401384083,33,0.014273356401384083,2279,0.985726643598616,20,0,0.0,3,0.15,3,0.15,17,0.85
-86.163,39.7655,155,0,0.0,35,0.22580645161290322,35,0.22580645161290322,120,0.7741935483870968,3,0,0.0,1,0.3333333333333333,1,0.3333333333333333,2,0.6666666666666666
-86.163,39.7665,28,0,0.0,0,0.0,0,0.0,28,1.0,2,0,0.0,0,0.0,0,0.0,2,1.0
-86.163,39.767,1947,0,0.0,1734,0.8906009244992296,1734,0.8906009244992296,213,0.10939907550077041,40,0,0.0,25,0.625,25,0.625,15,0.375
-86.163,39.7675,278,0,0.0,274,0.9856115107913669,274,0.9856115107913669,4,0.014388489208633094,3,0,0.0,2,0.6666666666666666,2,0.6666666666666666,1,0.3333333333333333
-86.163,39.768,418,0,0.0,53,0.12679425837320574,53,0.12679425837320574,365,0.8732057416267942,5,0,0.0,3,0.6,3,0.6,2,0.4
-86.163,39.7685,438,0,0.0,276,0.6301369863013698,276,0.6301369863013698,162,0.3698630136986301,5,0,0.0,3,0.6,3,0.6,2,0.4
-86.163,39.769,447,0,0.0,446,0.9977628635346756,446,0.9977628635346756,1,0.0022371364653243847,2,0,0.0,1,0.5,1,0.5,1,0.5
-86.163,39.7695,2968,0,0.0,1506,0.5074123989218329,1506,0.5074123989218329,1462,0.4925876010781671,29,0,0.0,11,0.3793103448275862,11,0.3793103448275862,18,0.6206896551724138
-86.163,39.77,5758,0,0.0,288,0.05001736714136853,288,0.05001736714136853,5470,0.9499826328586315,63,0,0.0,10,0.15873015873015872,10,0.15873015873015872,53,0.8412698412698413
-86.163,39.7705,4644,0,0.0,104,0.02239448751076658,104,0.02239448751076658,4540,0.9776055124892334,56,0,0.0,9,0.16071428571428573,9,0.16071428571428573,47,0.8392857142857143
-86.163,39.771,7309,0,0.0,42,0.005746340128608565,42,0.005746340128608565,7267,0.9942536598713915,51,0,0.0,3,0.058823529411764705,3,0.058823529411764705,48,0.9411764705882353
-86.163,39.7715,9692,0,0.0,131,0.013516302104828725,131,0.013516302104828725,9561,0.9864836978951713,28,0,0.0,4,0.14285714285714285,4,0.14285714285714285,24,0.8571428571428571
-86.163,39.772,4362,0,0.0,0,0.0,0,0.0,4362,1.0,44,0,0.0,0,0.0,0,0.0,44,1.0
-86.163,39.7725,6693,0,0.0,407,0.060809801284924546,407,0.060809801284924546,6286,0.9391901987150755,32,0,0.0,5,0.15625,5,0.15625,27,0.84375
-86.163,39.773,6022,0,0.0,34,0.005645964795748921,34,0.005645964795748921,5988,0.994354035204251,10,0,0.0,1,0.1,1,0.1,9,0.9
-86.163,39.7735,1731,0,0.0,129,0.07452339688041594,129,0.07452339688041594,1602,0.925476603119584,11,0,0.0,3,0.2727272727272727,3,0.2727272727272727,8,0.7272727272727273
-86.163,39.774,3074,0,0.0,682,0.22186076772934288,682,0.22186076772934288,2392,0.7781392322706572,42,0,0.0,18,0.42857142857142855,18,0.42857142857142855,24,0.5714285714285714
-86.163,39.7745,1208,0,0.0,516,0.4271523178807947,516,0.4271523178807947,692,0.5728476821192053,33,0,0.0,14,0.42424242424242425,14,0.42424242424242425,19,0.5757575757575758
-86.163,39.775,3472,0,0.0,2107,0.6068548387096774,2107,0.6068548387096774,1365,0.39314516129032256,35,0,0.0,17,0.4857142857142857,17,0.4857142857142857,18,0.5142857142857142
-86.163,39.7755,3749,0,0.0,2661,0.7097892771405708,2661,0.7097892771405708,1088,0.29021072285942917,58,0,0.0,33,0.5689655172413793,33,0.5689655172413793,25,0.43103448275862066
-86.163,39.776,1312,0,0.0,1039,0.791920731707317,1039,0.791920731707317,273,0.20807926829268292,29,0,0.0,20,0.6896551724137931,20,0.6896551724137931,9,0.3103448275862069
-86.163,39.7765,1100,0,0.0,889,0.8081818181818182,889,0.8081818181818182,211,0.1918181818181818,20,0,0.0,14,0.7,14,0.7,6,0.3
-86.163,39.777,1507,0,0.0,1185,0.7863304578633046,1185,0.7863304578633046,322,0.21366954213669542,26,0,0.0,16,0.6153846153846154,16,0.6153846153846154,10,0.38461538461538464
-86.163,39.7775,1082,0,0.0,981,0.9066543438077634,981,0.9066543438077634,101,0.0933456561922366,22,0,0.0,15,0.6818181818181818,15,0.6818181818181818,7,0.3181818181818182
-86.163,39.778,6338,0,0.0,6337,0.9998422215209846,6337,0.9998422215209846,1,0.0001577784790154623,17,0,0.0,16,0.9411764705882353,16,0.9411764705882353,1,0.058823529411764705
-86.163,39.7785,399,0,0.0,399,1.0,399,1.0,0,0.0,5,0,0.0,5,1.0,5,1.0,0,0.0
-86.163,39.779,297,0,0.0,243,0.8181818181818182,243,0.8181818181818182,54,0.18181818181818182,11,0,0.0,7,0.6363636363636364,7,0.6363636363636364,4,0.36363636363636365
-86.163,39.7795,248,0,0.0,194,0.782258064516129,194,0.782258064516129,54,0.21774193548387097,10,0,0.0,7,0.7,7,0.7,3,0.3
-86.163,39.78,150,0,0.0,124,0.8266666666666667,124,0.8266666666666667,26,0.17333333333333334,10,0,0.0,6,0.6,6,0.6,4,0.4
-86.163,39.7805,107,0,0.0,107,1.0,107,1.0,0,0.0,3,0,0.0,3,1.0,3,1.0,0,0.0
-86.1625,39.7615,516,0,0.0,2,0.003875968992248062,2,0.003875968992248062,514,0.9961240310077519,15,0,0.0,1,0.06666666666666667,1,0.06666666666666667,14,0.9333333333333333
-86.1625,39.7655,149,0,0.0,34,0.22818791946308725,34,0.22818791946308725,115,0.7718120805369127,2,0,0.0,1,0.5,1,0.5,1,0.5
-86.1625,39.7665,29,0,0.0,0,0.0,0,0.0,29,1.0,2,0,0.0,0,0.0,0,0.0,2,1.0
-86.1625,39.767,968,0,0.0,757,0.7820247933884298,757,0.7820247933884298,211,0.21797520661157024,55,0,0.0,31,0.5636363636363636,31,0.5636363636363636,24,0.43636363636363634
-86.1625,39.7675,325,0,0.0,325,1.0,325,1.0,0,0.0,1,0,0.0,1,1.0,1,1.0,0,0.0
-86.1625,39.769,4,0,0.0,0,0.0,0,0.0,4,1.0,1,0,0.0,0,0.0,0,0.0,1,1.0
-86.1625,39.7695,1644,0,0.0,690,0.4197080291970803,690,0.4197080291970803,954,0.5802919708029197,25,0,0.0,10,0.4,10,0.4,15,0.6
-86.1625,39.77,1143,0,0.0,418,0.3657042869641295,418,0.3657042869641295,725,0.6342957130358705,60,0,0.0,19,0.31666666666666665,19,0.31666666666666665,41,0.6833333333333333
-86.1625,39.7705,3,0,0.0,3,1.0,3,1.0,0,0.0,1,0,0.0,1,1.0,1,1.0,0,0.0
-86.1625,39.771,2093,0,0.0,52,0.024844720496894408,52,0.024844720496894408,2041,0.9751552795031055,20,0,0.0,4,0.2,4,0.2,16,0.8
-86.1625,39.7715,9,0,0.0,0,0.0,0,0.0,9,1.0,1,0,0.0,0,0.0,0,0.0,1,1.0
-86.1625,39.772,3,0,0.0,0,0.0,0,0.0,3,1.0,1,0,0.0,0,0.0,0,0.0,1,1.0
-86.1625,39.7725,891,0,0.0,110,0.12345679012345678,110,0.12345679012345678,781,0.8765432098765432,9,0,0.0,4,0.4444444444444444,4,0.4444444444444444,5,0.5555555555555556
-86.1625,39.774,815,0,0.0,595,0.7300613496932515,595,0.7300613496932515,220,0.26993865030674846,45,0,0.0,25,0.5555555555555556,25,0.5555555555555556,20,0.4444444444444444
-86.1625,39.7755,469,0,0.0,451,0.9616204690831557,451,0.9616204690831557,18,0.03837953091684435,16,0,0.0,12,0.75,12,0.75,4,0.25
-86.1625,39.778,942,0,0.0,941,0.9989384288747346,941,0.9989384288747346,1,0.0010615711252653928,8,0,0.0,7,0.875,7,0.875,1,0.125
-86.1625,39.78,96,0,0.0,41,0.4270833333333333,41,0.4270833333333333,55,0.5729166666666666,2,0,0.0,1,0.5,1,0.5,1,0.5
-86.1625,39.7805,358,0,0.0,275,0.7681564245810056,275,0.7681564245810056,83,0.23184357541899442,5,0,0.0,3,0.6,3,0.6,2,0.4
-86.162,39.761,768,0,0.0,0,0.0,0,0.0,768,1.0,3,0,0.0,0,0.0,0,0.0,3,1.0
-86.162,39.7615,901,0,0.0,12,0.013318534961154272,12,0.013318534961154272,889,0.9866814650388457,13,0,0.0,1,0.07692307692307693,1,0.07692307692307693,12,0.9230769230769231
-86.162,39.7655,156,0,0.0,37,0.23717948717948717,37,0.23717948717948717,119,0.7628205128205128,2,0,0.0,1,0.5,1,0.5,1,0.5
-86.162,39.7665,32,0,0.0,0,0.0,0,0.0,32,1.0,1,0,0.0,0,0.0,0,0.0,1,1.0
-86.162,39.767,4351,0,0.0,4174,0.9593196966214663,4174,0.9593196966214663,177,0.04068030337853367,37,0,0.0,24,0.6486486486486487,24,0.6486486486486487,13,0.35135135135135137
-86.162,39.7675,318,0,0.0,294,0.9245283018867925,294,0.9245283018867925,24,0.07547169811320754,4,0,0.0,2,0.5,2,0.5,2,0.5
-86.162,39.7685,20,0,0.0,0,0.0,0,0.0,20,1.0,2,0,0.0,0,0.0,0,0.0,2,1.0
-86.162,39.7695,1337,0,0.0,530,0.39640987284966345,530,0.39640987284966345,807,0.6035901271503366,41,0,0.0,19,0.4634146341463415,19,0.4634146341463415,22,0.5365853658536586
-86.162,39.77,843,0,0.0,383,0.4543297746144721,383,0.4543297746144721,460,0.5456702253855279,48,0,0.0,19,0.3958333333333333,19,0.3958333333333333,29,0.6041666666666666
-86.162,39.771,2748,0,0.0,1789,0.651018922852984,1789,0.651018922852984,959,0.34898107714701604,95,0,0.0,35,0.3684210526315789,35,0.3684210526315789,60,0.631578947368421
-86.162,39.7715,2,0,0.0,2,1.0,2,1.0,0,0.0,1,0,0.0,1,1.0,1,1.0,0,0.0
-86.162,39.7725,257,0,0.0,123,0.4785992217898833,123,0.4785992217898833,134,0.5214007782101168,6,0,0.0,3,0.5,3,0.5,3,0.5
-86.162,39.774,835,0,0.0,807,0.9664670658682635,807,0.9664670658682635,28,0.033532934131736525,17,0,0.0,14,0.8235294117647058,14,0.8235294117647058,3,0.17647058823529413
-86.162,39.7755,380,0,0.0,380,1.0,380,1.0,0,0.0,10,0,0.0,10,1.0,10,1.0,0,0.0
-86.162,39.778,446,0,0.0,405,0.9080717488789237,405,0.9080717488789237,41,0.09192825112107623,7,0,0.0,6,0.8571428571428571,6,0.8571428571428571,1,0.14285714285714285
-86.162,39.7805,38,0,0.0,38,1.0,38,1.0,0,0.0,2,0,0.0,2,1.0,2,1.0,0,0.0
-86.1615,39.761,1432,0,0.0,157,0.10963687150837989,157,0.10963687150837989,1275,0.8903631284916201,21,0,0.0,4,0.19047619047619047,4,0.19047619047619047,17,0.8095238095238095
-86.1615,39.7615,8253,0,0.0,1460,0.1769053677450624,1460,0.1769053677450624,6793,0.8230946322549376,54,0,0.0,17,0.3148148148148148,17,0.3148148148148148,37,0.6851851851851852
-86.1615,39.762,2209,0,0.0,1495,0.6767768220914441,1495,0.6767768220914441,714,0.3232231779085559,40,0,0.0,24,0.6,24,0.6,16,0.4
-86.1615,39.7625,1083,0,0.0,1011,0.9335180055401662,1011,0.9335180055401662,72,0.0664819944598338,23,0,0.0,20,0.8695652173913043,20,0.8695652173913043,3,0.13043478260869565
-86.1615,39.763,955,0,0.0,783,0.8198952879581152,783,0.8198952879581152,172,0.18010471204188483,45,0,0.0,33,0.7333333333333333,33,0.7333333333333333,12,0.26666666666666666
-86.1615,39.7635,997,0,0.0,931,0.9338014042126379,931,0.9338014042126379,66,0.06619859578736209,22,0,0.0,19,0.8636363636363636,19,0.8636363636363636,3,0.13636363636363635
-86.1615,39.764,1205,0,0.0,1130,0.9377593360995851,1130,0.9377593360995851,75,0.06224066390041494,28,0,0.0,23,0.8214285714285714,23,0.8214285714285714,5,0.17857142857142858
-86.1615,39.7645,1438,0,0.0,1322,0.9193324061196105,1322,0.9193324061196105,116,0.08066759388038942,47,0,0.0,35,0.7446808510638298,35,0.7446808510638298,12,0.2553191489361702
-86.1615,39.765,1062,0,0.0,843,0.7937853107344632,843,0.7937853107344632,219,0.2062146892655367,45,0,0.0,31,0.6888888888888889,31,0.6888888888888889,14,0.3111111111111111
-86.1615,39.7655,2931,0,0.0,2542,0.867280791538724,2542,0.867280791538724,389,0.13271920846127602,32,0,0.0,24,0.75,24,0.75,8,0.25
-86.1615,39.766,2739,0,0.0,2225,0.8123402701715955,2225,0.8123402701715955,514,0.18765972982840454,36,0,0.0,26,0.7222222222222222,26,0.7222222222222222,10,0.2777777777777778
-86.1615,39.7665,1765,0,0.0,1306,0.739943342776204,1306,0.739943342776204,459,0.26005665722379606,66,0,0.0,40,0.6060606060606061,40,0.6060606060606061,26,0.3939393939393939
-86.1615,39.767,5600,0,0.0,3118,0.5567857142857143,3118,0.5567857142857143,2482,0.4432142857142857,96,0,0.0,44,0.4583333333333333,44,0.4583333333333333,52,0.5416666666666666
-86.1615,39.7675,4785,0,0.0,983,0.20543364681295717,983,0.20543364681295717,3802,0.7945663531870428,37,0,0.0,14,0.3783783783783784,14,0.3783783783783784,23,0.6216216216216216
-86.1615,39.768,3550,0,0.0,452,0.12732394366197183,452,0.12732394366197183,3098,0.8726760563380281,43,0,0.0,11,0.2558139534883721,11,0.2558139534883721,32,0.7441860465116279
-86.1615,39.7685,4016,0,0.0,342,0.08515936254980079,342,0.08515936254980079,3674,0.9148406374501992,35,0,0.0,7,0.2,7,0.2,28,0.8
-86.1615,39.769,4144,0,0.0,914,0.22055984555984556,914,0.22055984555984556,3230,0.7794401544401545,35,0,0.0,4,0.11428571428571428,4,0.11428571428571428,31,0.8857142857142857
-86.1615,39.7695,6510,0,0.0,630,0.0967741935483871,630,0.0967741935483871,5880,0.9032258064516129,75,0,0.0,15,0.2,15,0.2,60,0.8
-86.1615,39.77,6256,0,0.0,685,0.10949488491048594,685,0.10949488491048594,5571,0.890505115089514,50,0,0.0,7,0.14,7,0.14,43,0.86
-86.1615,39.7705,3649,0,0.0,716,0.19621814195670045,716,0.19621814195670045,2933,0.8037818580432995,49,0,0.0,17,0.3469387755102041,17,0.3469387755102041,32,0.6530612244897959
-86.1615,39.771,6993,0,0.0,5488,0.7847847847847848,5488,0.7847847847847848,1505,0.21521521521521522,92,0,0.0,54,0.5869565217391305,54,0.5869565217391305,38,0.41304347826086957
-86.1615,39.7715,3585,0,0.0,1807,0.504044630404463,1807,0.504044630404463,1778,0.49595536959553693,48,0,0.0,23,0.4791666666666667,23,0.4791666666666667,25,0.5208333333333334
-86.1615,39.772,1531,0,0.0,506,0.33050293925538865,506,0.33050293925538865,1025,0.6694970607446113,63,0,0.0,20,0.31746031746031744,20,0.31746031746031744,43,0.6825396825396826
-86.1615,39.7725,3477,0,0.0,2216,0.637331032499281,2216,0.637331032499281,1261,0.36266896750071903,48,0,0.0,18,0.375,18,0.375,30,0.625
-86.1615,39.773,865,0,0.0,435,0.5028901734104047,435,0.5028901734104047,430,0.49710982658959535,25,0,0.0,14,0.56,14,0.56,11,0.44
-86.1615,39.7735,98,0,0.0,47,0.47959183673469385,47,0.47959183673469385,51,0.5204081632653061,7,0,0.0,4,0.5714285714285714,4,0.5714285714285714,3,0.42857142857142855
-86.1615,39.774,965,0,0.0,663,0.6870466321243524,663,0.6870466321243524,302,0.31295336787564765,95,0,0.0,54,0.5684210526315789,54,0.5684210526315789,41,0.43157894736842106
-86.1615,39.7745,62,0,0.0,0,0.0,0,0.0,62,1.0,2,0,0.0,0,0.0,0,0.0,2,1.0
-86.1615,39.775,13,0,0.0,0,0.0,0,0.0,13,1.0,1,0,0.0,0,0.0,0,0.0,1,1.0
-86.1615,39.7755,1110,0,0.0,1105,0.9954954954954955,1105,0.9954954954954955,5,0.0045045045045045045,12,0,0.0,11,0.9166666666666666,11,0.9166666666666666,1,0.08333333333333333
-86.1615,39.776,52,0,0.0,0,0.0,0,0.0,52,1.0,1,0,0.0,0,0.0,0,0.0,1,1.0
-86.1615,39.7765,64,0,0.0,0,0.0,0,0.0,64,1.0,1,0,0.0,0,0.0,0,0.0,1,1.0
-86.1615,39.778,749,0,0.0,718,0.9586114819759679,718,0.9586114819759679,31,0.04138851802403204,11,0,0.0,8,0.7272727272727273,8,0.7272727272727273,3,0.2727272727272727
-86.1615,39.7805,45,0,0.0,45,1.0,45,1.0,0,0.0,2,0,0.0,2,1.0,2,1.0,0,0.0
-86.161,39.761,564,0,0.0,57,0.10106382978723404,57,0.10106382978723404,507,0.898936170212766,13,0,0.0,3,0.23076923076923078,3,0.23076923076923078,10,0.7692307692307693
-86.161,39.7615,1799,0,0.0,94,0.05225125069483046,94,0.05225125069483046,1705,0.9477487493051695,41,0,0.0,3,0.07317073170731707,3,0.07317073170731707,38,0.926829268292683
-86.161,39.7655,6047,0,0.0,883,0.14602282123366958,883,0.14602282123366958,5164,0.8539771787663304,28,0,0.0,12,0.42857142857142855,12,0.42857142857142855,16,0.5714285714285714
-86.161,39.7665,57,0,0.0,0,0.0,0,0.0,57,1.0,1,0,0.0,0,0.0,0,0.0,1,1.0
-86.161,39.767,3998,0,0.0,3816,0.9544772386193097,3816,0.9544772386193097,182,0.04552276138069034,36,0,0.0,28,0.7777777777777778,28,0.7777777777777778,8,0.2222222222222222
-86.161,39.7675,312,0,0.0,155,0.4967948717948718,155,0.4967948717948718,157,0.5032051282051282,6,0,0.0,3,0.5,3,0.5,3,0.5
-86.161,39.768,52,0,0.0,21,0.40384615384615385,21,0.40384615384615385,31,0.5961538461538461,5,0,0.0,2,0.4,2,0.4,3,0.6
-86.161,39.7685,63,0,0.0,0,0.0,0,0.0,63,1.0,1,0,0.0,0,0.0,0,0.0,1,1.0
-86.161,39.769,388,0,0.0,0,0.0,0,0.0,388,1.0,2,0,0.0,0,0.0,0,0.0,2,1.0
-86.161,39.7695,7824,0,0.0,130,0.016615541922290387,130,0.016615541922290387,7694,0.9833844580777096,47,0,0.0,5,0.10638297872340426,5,0.10638297872340426,42,0.8936170212765957
-86.161,39.77,5061,0,0.0,137,0.027069749061450307,137,0.027069749061450307,4924,0.9729302509385497,42,0,0.0,6,0.14285714285714285,6,0.14285714285714285,36,0.8571428571428571
-86.161,39.7705,1347,0,0.0,187,0.13882702301410543,187,0.13882702301410543,1160,0.8611729769858946,18,0,0.0,1,0.05555555555555555,1,0.05555555555555555,17,0.9444444444444444
-86.161,39.771,2824,0,0.0,2180,0.7719546742209632,2180,0.7719546742209632,644,0.22804532577903683,61,0,0.0,33,0.5409836065573771,33,0.5409836065573771,28,0.45901639344262296
-86.161,39.7715,357,0,0.0,196,0.5490196078431373,196,0.5490196078431373,161,0.45098039215686275,9,0,0.0,4,0.4444444444444444,4,0.4444444444444444,5,0.5555555555555556
-86.161,39.772,358,0,0.0,59,0.164804469273743,59,0.164804469273743,299,0.835195530726257,20,0,0.0,7,0.35,7,0.35,13,0.65
-86.161,39.7725,1902,0,0.0,899,0.4726603575184017,899,0.4726603575184017,1003,0.5273396424815984,45,0,0.0,18,0.4,18,0.4,27,0.6
-86.161,39.773,928,0,0.0,366,0.39439655172413796,366,0.39439655172413796,562,0.6056034482758621,21,0,0.0,12,0.5714285714285714,12,0.5714285714285714,9,0.42857142857142855
-86.161,39.7735,1196,0,0.0,559,0.4673913043478261,559,0.4673913043478261,637,0.532608695652174,29,0,0.0,17,0.5862068965517241,17,0.5862068965517241,12,0.41379310344827586
-86.161,39.774,7283,0,0.0,5550,0.7620486063435398,5550,0.7620486063435398,1733,0.23795139365646026,82,0,0.0,50,0.6097560975609756,50,0.6097560975609756,32,0.3902439024390244
-86.161,39.7745,1670,0,0.0,944,0.5652694610778443,944,0.5652694610778443,726,0.4347305389221557,28,0,0.0,17,0.6071428571428571,17,0.6071428571428571,11,0.39285714285714285
-86.161,39.775,1110,0,0.0,788,0.7099099099099099,788,0.7099099099099099,322,0.29009009009009007,31,0,0.0,19,0.6129032258064516,19,0.6129032258064516,12,0.3870967741935484
-86.161,39.7755,4161,0,0.0,3789,0.9105984138428262,3789,0.9105984138428262,372,0.08940158615717375,35,0,0.0,25,0.7142857142857143,25,0.7142857142857143,10,0.2857142857142857
-86.161,39.776,539,0,0.0,438,0.8126159554730983,438,0.8126159554730983,101,0.18738404452690166,11,0,0.0,8,0.7272727272727273,8,0.7272727272727273,3,0.2727272727272727
-86.161,39.7765,2070,0,0.0,1400,0.6763285024154589,1400,0.6763285024154589,670,0.32367149758454106,9,0,0.0,7,0.7777777777777778,7,0.7777777777777778,2,0.2222222222222222
-86.161,39.777,1264,0,0.0,789,0.6242088607594937,789,0.6242088607594937,475,0.37579113924050633,13,0,0.0,9,0.6923076923076923,9,0.6923076923076923,4,0.3076923076923077
-86.161,39.7775,625,0,0.0,409,0.6544,409,0.6544,216,0.3456,21,0,0.0,13,0.6190476190476191,13,0.6190476190476191,8,0.38095238095238093
-86.161,39.778,4523,0,0.0,3620,0.8003537475127128,3620,0.8003537475127128,903,0.1996462524872872,40,0,0.0,23,0.575,23,0.575,17,0.425
-86.161,39.7785,210,0,0.0,197,0.9380952380952381,197,0.9380952380952381,13,0.06190476190476191,7,0,0.0,5,0.7142857142857143,5,0.7142857142857143,2,0.2857142857142857
-86.161,39.779,215,0,0.0,208,0.9674418604651163,208,0.9674418604651163,7,0.03255813953488372,6,0,0.0,5,0.8333333333333334,5,0.8333333333333334,1,0.16666666666666666
-86.161,39.7795,187,0,0.0,187,1.0,187,1.0,0,0.0,4,0,0.0,4,1.0,4,1.0,0,0.0
-86.161,39.78,173,0,0.0,173,1.0,173,1.0,0,0.0,4,0,0.0,4,1.0,4,1.0,0,0.0
-86.161,39.7805,291,0,0.0,291,1.0,291,1.0,0,0.0,4,0,0.0,4,1.0,4,1.0,0,0.0
-86.1605,39.761,500,0,0.0,43,0.086,43,0.086,457,0.914,20,0,0.0,1,0.05,1,0.05,19,0.95
-86.1605,39.7615,1436,0,0.0,90,0.06267409470752089,90,0.06267409470752089,1346,0.9373259052924791,44,0,0.0,3,0.06818181818181818,3,0.06818181818181818,41,0.9318181818181818
-86.1605,39.7655,541,0,0.0,320,0.5914972273567468,320,0.5914972273567468,221,0.40850277264325324,8,0,0.0,7,0.875,7,0.875,1,0.125
-86.1605,39.767,1625,0,0.0,1435,0.8830769230769231,1435,0.8830769230769231,190,0.11692307692307692,33,0,0.0,25,0.7575757575757576,25,0.7575757575757576,8,0.24242424242424243
-86.1605,39.7675,3,0,0.0,0,0.0,0,0.0,3,1.0,1,0,0.0,0,0.0,0,0.0,1,1.0
-86.1605,39.768,1,0,0.0,0,0.0,0,0.0,1,1.0,1,0,0.0,0,0.0,0,0.0,1,1.0
-86.1605,39.7685,260,0,0.0,260,1.0,260,1.0,0,0.0,1,0,0.0,1,1.0,1,1.0,0,0.0
-86.1605,39.769,55,0,0.0,0,0.0,0,0.0,55,1.0,2,0,0.0,0,0.0,0,0.0,2,1.0
-86.1605,39.7695,2503,0,0.0,248,0.09908110267678785,248,0.09908110267678785,2255,0.9009188973232122,53,0,0.0,8,0.1509433962264151,8,0.1509433962264151,45,0.8490566037735849
-86.1605,39.77,1430,0,0.0,518,0.3622377622377622,518,0.3622377622377622,912,0.6377622377622377,22,0,0.0,6,0.2727272727272727,6,0.2727272727272727,16,0.7272727272727273
-86.1605,39.771,2907,0,0.0,733,0.2521499828001376,733,0.2521499828001376,2174,0.7478500171998624,62,0,0.0,24,0.3870967741935484,24,0.3870967741935484,38,0.6129032258064516
-86.1605,39.7715,36,0,0.0,29,0.8055555555555556,29,0.8055555555555556,7,0.19444444444444445,2,0,0.0,1,0.5,1,0.5,1,0.5
-86.1605,39.7725,572,0,0.0,446,0.7797202797202797,446,0.7797202797202797,126,0.2202797202797203,13,0,0.0,9,0.6923076923076923,9,0.6923076923076923,4,0.3076923076923077
-86.1605,39.773,2,0,0.0,2,1.0,2,1.0,0,0.0,1,0,0.0,1,1.0,1,1.0,0,0.0
-86.1605,39.774,1079,0,0.0,1006,0.9323447636700649,1006,0.9323447636700649,73,0.06765523632993513,48,0,0.0,37,0.7708333333333334,37,0.7708333333333334,11,0.22916666666666666
-86.1605,39.7755,1268,0,0.0,1145,0.9029968454258676,1145,0.9029968454258676,123,0.09700315457413249,18,0,0.0,16,0.8888888888888888,16,0.8888888888888888,2,0.1111111111111111
-86.1605,39.778,1121,0,0.0,939,0.8376449598572703,939,0.8376449598572703,182,0.1623550401427297,22,0,0.0,13,0.5909090909090909,13,0.5909090909090909,9,0.4090909090909091
-86.16,39.761,6602,0,0.0,427,0.06467737049378976,427,0.06467737049378976,6175,0.9353226295062103,51,0,0.0,10,0.19607843137254902,10,0.19607843137254902,41,0.803921568627451
-86.16,39.7615,4096,0,0.0,381,0.093017578125,381,0.093017578125,3715,0.906982421875,37,0,0.0,2,0.05405405405405406,2,0.05405405405405406,35,0.9459459459459459
-86.16,39.762,1070,0,0.0,193,0.18037383177570093,193,0.18037383177570093,877,0.819626168224299,47,0,0.0,10,0.2127659574468085,10,0.2127659574468085,37,0.7872340425531915
-86.16,39.7625,4423,0,0.0,3827,0.8652498304318336,3827,0.8652498304318336,596,0.1347501695681664,24,0,0.0,15,0.625,15,0.625,9,0.375
-86.16,39.763,1838,0,0.0,1542,0.8389553862894451,1542,0.8389553862894451,296,0.16104461371055495,17,0,0.0,12,0.7058823529411765,12,0.7058823529411765,5,0.29411764705882354
-86.16,39.7635,1120,0,0.0,888,0.7928571428571428,888,0.7928571428571428,232,0.20714285714285716,43,0,0.0,24,0.5581395348837209,24,0.5581395348837209,19,0.4418604651162791
-86.16,39.764,1680,0,0.0,1638,0.975,1638,0.975,42,0.025,22,0,0.0,15,0.6818181818181818,15,0.6818181818181818,7,0.3181818181818182
-86.16,39.7645,613,0,0.0,584,0.9526916802610114,584,0.9526916802610114,29,0.04730831973898858,10,0,0.0,8,0.8,8,0.8,2,0.2
-86.16,39.765,917,0,0.0,832,0.9073064340239912,832,0.9073064340239912,85,0.09269356597600872,39,0,0.0,29,0.7435897435897436,29,0.7435897435897436,10,0.2564102564102564
-86.16,39.7655,3082,0,0.0,1646,0.5340687865022713,1646,0.5340687865022713,1436,0.46593121349772876,30,0,0.0,22,0.7333333333333333,22,0.7333333333333333,8,0.26666666666666666
-86.16,39.766,1350,0,0.0,1346,0.997037037037037,1346,0.997037037037037,4,0.002962962962962963,7,0,0.0,6,0.8571428571428571,6,0.8571428571428571,1,0.14285714285714285
-86.16,39.7665,1830,0,0.0,1563,0.8540983606557377,1563,0.8540983606557377,267,0.14590163934426228,29,0,0.0,20,0.6896551724137931,20,0.6896551724137931,9,0.3103448275862069
-86.16,39.767,4833,0,0.0,4554,0.9422718808193669,4554,0.9422718808193669,279,0.05772811918063315,66,0,0.0,46,0.696969696969697,46,0.696969696969697,20,0.30303030303030304
-86.16,39.7675,1485,0,0.0,1237,0.832996632996633,1237,0.832996632996633,248,0.16700336700336701,17,0,0.0,13,0.7647058823529411,13,0.7647058823529411,4,0.23529411764705882
-86.16,39.768,2643,0,0.0,2513,0.9508134695421869,2513,0.9508134695421869,130,0.04918653045781309,20,0,0.0,15,0.75,15,0.75,5,0.25
-86.16,39.7685,1354,0,0.0,1233,0.9106351550960118,1233,0.9106351550960118,121,0.08936484490398819,15,0,0.0,12,0.8,12,0.8,3,0.2
-86.16,39.769,473,0,0.0,349,0.7378435517970402,349,0.7378435517970402,124,0.26215644820295986,13,0,0.0,8,0.6153846153846154,8,0.6153846153846154,5,0.38461538461538464
-86.16,39.7695,7401,0,0.0,5765,0.778948790703959,5765,0.778948790703959,1636,0.22105120929604108,57,0,0.0,28,0.49122807017543857,28,0.49122807017543857,29,0.5087719298245614
-86.16,39.77,2896,0,0.0,1821,0.6287983425414365,1821,0.6287983425414365,1075,0.37120165745856354,34,0,0.0,16,0.47058823529411764,16,0.47058823529411764,18,0.5294117647058824
-86.16,39.7705,59,0,0.0,59,1.0,59,1.0,0,0.0,2,0,0.0,2,1.0,2,1.0,0,0.0
-86.16,39.771,2506,0,0.0,192,0.07661612130885874,192,0.07661612130885874,2314,0.9233838786911412,62,0,0.0,11,0.1774193548387097,11,0.1774193548387097,51,0.8225806451612904
-86.16,39.7715,39,0,0.0,0,0.0,0,0.0,39,1.0,1,0,0.0,0,0.0,0,0.0,1,1.0
-86.16,39.7725,4344,0,0.0,4294,0.9884898710865562,4294,0.9884898710865562,50,0.01151012891344383,13,0,0.0,10,0.7692307692307693,10,0.7692307692307693,3,0.23076923076923078
-86.16,39.774,1029,0,0.0,1013,0.9844509232264335,1013,0.9844509232264335,16,0.015549076773566569,26,0,0.0,21,0.8076923076923077,21,0.8076923076923077,5,0.19230769230769232
-86.16,39.775,21,0,0.0,0,0.0,0,0.0,21,1.0,1,0,0.0,0,0.0,0,0.0,1,1.0
-86.16,39.7755,739,0,0.0,644,0.871447902571042,644,0.871447902571042,95,0.12855209742895804,21,0,0.0,17,0.8095238095238095,17,0.8095238095238095,4,0.19047619047619047
-86.16,39.7775,72,0,0.0,69,0.9583333333333334,69,0.9583333333333334,3,0.041666666666666664,3,0,0.0,2,0.6666666666666666,2,0.6666666666666666,1,0.3333333333333333
-86.16,39.778,495,0,0.0,383,0.7737373737373737,383,0.7737373737373737,112,0.22626262626262628,18,0,0.0,11,0.6111111111111112,11,0.6111111111111112,7,0.3888888888888889
-86.1595,39.761,261,0,0.0,0,0.0,0,0.0,261,1.0,7,0,0.0,0,0.0,0,0.0,7,1.0
-86.1595,39.7615,1856,0,0.0,0,0.0,0,0.0,1856,1.0,6,0,0.0,0,0.0,0,0.0,6,1.0
-86.1595,39.7625,90,0,0.0,90,1.0,90,1.0,0,0.0,1,0,0.0,1,1.0,1,1.0,0,0.0
-86.1595,39.763,75,0,0.0,75,1.0,75,1.0,0,0.0,1,0,0.0,1,1.0,1,1.0,0,0.0
-86.1595,39.7635,42,0,0.0,22,0.5238095238095238,22,0.5238095238095238,20,0.47619047619047616,8,0,0.0,5,0.625,5,0.625,3,0.375
-86.1595,39.764,390,0,0.0,349,0.8948717948717949,349,0.8948717948717949,41,0.10512820512820513,9,0,0.0,8,0.8888888888888888,8,0.8888888888888888,1,0.1111111111111111
-86.1595,39.7645,420,0,0.0,377,0.8976190476190476,377,0.8976190476190476,43,0.10238095238095238,7,0,0.0,6,0.8571428571428571,6,0.8571428571428571,1,0.14285714285714285
-86.1595,39.765,1428,0,0.0,1339,0.9376750700280112,1339,0.9376750700280112,89,0.062324929971988796,33,0,0.0,22,0.6666666666666666,22,0.6666666666666666,11,0.3333333333333333
-86.1595,39.7655,1266,0,0.0,953,0.7527646129541864,953,0.7527646129541864,313,0.24723538704581358,23,0,0.0,19,0.8260869565217391,19,0.8260869565217391,4,0.17391304347826086
-86.1595,39.766,1314,0,0.0,1196,0.9101978691019786,1196,0.9101978691019786,118,0.0898021308980213,16,0,0.0,13,0.8125,13,0.8125,3,0.1875
-86.1595,39.7665,4836,0,0.0,4368,0.9032258064516129,4368,0.9032258064516129,468,0.0967741935483871,95,0,0.0,60,0.631578947368421,60,0.631578947368421,35,0.3684210526315789
-86.1595,39.767,13407,0,0.0,12293,0.9169090773476543,12293,0.9169090773476543,1114,0.08309092265234579,303,0,0.0,202,0.6666666666666666,202,0.6666666666666666,101,0.3333333333333333
-86.1595,39.7675,14410,0,0.0,13690,0.9500346981263011,13690,0.9500346981263011,720,0.04996530187369882,161,0,0.0,107,0.6645962732919255,107,0.6645962732919255,54,0.33540372670807456
-86.1595,39.768,17583,0,0.0,16530,0.9401126087698345,16530,0.9401126087698345,1053,0.0598873912301655,190,0,0.0,115,0.6052631578947368,115,0.6052631578947368,75,0.39473684210526316
-86.1595,39.7685,9767,0,0.0,9049,0.9264871506091942,9049,0.9264871506091942,718,0.07351284939080577,91,0,0.0,67,0.7362637362637363,67,0.7362637362637363,24,0.26373626373626374
-86.1595,39.769,9906,0,0.0,8910,0.8994548758328286,8910,0.8994548758328286,996,0.10054512416717142,187,0,0.0,113,0.6042780748663101,113,0.6042780748663101,74,0.39572192513368987
-86.1595,39.7695,20149,0,0.0,18295,0.9079855079656559,18295,0.9079855079656559,1854,0.09201449203434414,141,0,0.0,92,0.6524822695035462,92,0.6524822695035462,49,0.3475177304964539
-86.1595,39.77,8835,0,0.0,6620,0.7492925863044708,6620,0.7492925863044708,2215,0.2507074136955291,134,0,0.0,80,0.5970149253731343,80,0.5970149253731343,54,0.40298507462686567
-86.1595,39.7705,9022,0,0.0,6135,0.6800044336067391,6135,0.6800044336067391,2887,0.31999556639326093,122,0,0.0,65,0.5327868852459017,65,0.5327868852459017,57,0.4672131147540984
-86.1595,39.771,8640,0,0.0,2612,0.3023148148148148,2612,0.3023148148148148,6028,0.6976851851851852,57,0,0.0,20,0.3508771929824561,20,0.3508771929824561,37,0.6491228070175439
-86.1595,39.7715,2612,0,0.0,395,0.15122511485451762,395,0.15122511485451762,2217,0.8487748851454824,37,0,0.0,11,0.2972972972972973,11,0.2972972972972973,26,0.7027027027027027
-86.1595,39.772,2747,0,0.0,1145,0.4168183472879505,1145,0.4168183472879505,1602,0.5831816527120495,66,0,0.0,26,0.3939393939393939,26,0.3939393939393939,40,0.6060606060606061
-86.1595,39.7725,3536,0,0.0,2931,0.8289027149321267,2931,0.8289027149321267,605,0.1710972850678733,45,0,0.0,27,0.6,27,0.6,18,0.4
-86.1595,39.773,1391,0,0.0,1071,0.7699496764917325,1071,0.7699496764917325,320,0.23005032350826743,23,0,0.0,14,0.6086956521739131,14,0.6086956521739131,9,0.391304347826087
-86.1595,39.7735,1364,0,0.0,1026,0.7521994134897361,1026,0.7521994134897361,338,0.24780058651026393,21,0,0.0,14,0.6666666666666666,14,0.6666666666666666,7,0.3333333333333333
-86.1595,39.774,2672,0,0.0,2356,0.8817365269461078,2356,0.8817365269461078,316,0.11826347305389222,37,0,0.0,27,0.7297297297297297,27,0.7297297297297297,10,0.2702702702702703
-86.1595,39.7745,1648,0,0.0,1301,0.7894417475728155,1301,0.7894417475728155,347,0.21055825242718446,18,0,0.0,12,0.6666666666666666,12,0.6666666666666666,6,0.3333333333333333
-86.1595,39.775,2628,0,0.0,2149,0.8177321156773212,2149,0.8177321156773212,479,0.18226788432267885,43,0,0.0,22,0.5116279069767442,22,0.5116279069767442,21,0.4883720930232558
-86.1595,39.7755,2998,0,0.0,2705,0.9022681787858572,2705,0.9022681787858572,293,0.09773182121414276,79,0,0.0,48,0.6075949367088608,48,0.6075949367088608,31,0.3924050632911392
-86.1595,39.776,3134,0,0.0,2648,0.8449266113592853,2648,0.8449266113592853,486,0.15507338864071474,21,0,0.0,12,0.5714285714285714,12,0.5714285714285714,9,0.42857142857142855
-86.1595,39.7765,1386,0,0.0,1254,0.9047619047619048,1254,0.9047619047619048,132,0.09523809523809523,14,0,0.0,8,0.5714285714285714,8,0.5714285714285714,6,0.42857142857142855
-86.1595,39.777,387,0,0.0,298,0.7700258397932817,298,0.7700258397932817,89,0.22997416020671835,10,0,0.0,7,0.7,7,0.7,3,0.3
-86.1595,39.7775,378,0,0.0,299,0.791005291005291,299,0.791005291005291,79,0.20899470899470898,8,0,0.0,4,0.5,4,0.5,4,0.5
-86.1595,39.778,2437,0,0.0,2239,0.9187525646286417,2239,0.9187525646286417,198,0.08124743537135823,22,0,0.0,13,0.5909090909090909,13,0.5909090909090909,9,0.4090909090909091
-86.1595,39.7785,40,0,0.0,0,0.0,0,0.0,40,1.0,2,0,0.0,0,0.0,0,0.0,2,1.0
-86.1595,39.7805,49,0,0.0,49,1.0,49,1.0,0,0.0,1,0,0.0,1,1.0,1,1.0,0,0.0
-86.159,39.761,242,0,0.0,0,0.0,0,0.0,242,1.0,7,0,0.0,0,0.0,0,0.0,7,1.0
-86.159,39.7615,146,0,0.0,0,0.0,0,0.0,146,1.0,5,0,0.0,0,0.0,0,0.0,5,1.0
-86.159,39.764,46,0,0.0,42,0.9130434782608695,42,0.9130434782608695,4,0.08695652173913043,3,0,0.0,2,0.6666666666666666,2,0.6666666666666666,1,0.3333333333333333
-86.159,39.7655,357,0,0.0,176,0.49299719887955185,176,0.49299719887955185,181,0.5070028011204482,8,0,0.0,6,0.75,6,0.75,2,0.25
-86.159,39.766,3,0,0.0,3,1.0,3,1.0,0,0.0,1,0,0.0,1,1.0,1,1.0,0,0.0
-86.159,39.7665,182,0,0.0,182,1.0,182,1.0,0,0.0,4,0,0.0,4,1.0,4,1.0,0,0.0
-86.159,39.767,7093,0,0.0,6591,0.9292259974622867,6591,0.9292259974622867,502,0.07077400253771324,86,0,0.0,62,0.7209302325581395,62,0.7209302325581395,24,0.27906976744186046
-86.159,39.7675,426,0,0.0,308,0.7230046948356808,308,0.7230046948356808,118,0.27699530516431925,9,0,0.0,6,0.6666666666666666,6,0.6666666666666666,3,0.3333333333333333
-86.159,39.7685,340,0,0.0,330,0.9705882352941176,330,0.9705882352941176,10,0.029411764705882353,8,0,0.0,6,0.75,6,0.75,2,0.25
-86.159,39.7695,4119,0,0.0,3515,0.8533624666181112,3515,0.8533624666181112,604,0.1466375333818888,118,0,0.0,71,0.6016949152542372,71,0.6016949152542372,47,0.3983050847457627
-86.159,39.77,3120,0,0.0,1978,0.6339743589743589,1978,0.6339743589743589,1142,0.366025641025641,96,0,0.0,39,0.40625,39,0.40625,57,0.59375
-86.159,39.7705,3,0,0.0,3,1.0,3,1.0,0,0.0,1,0,0.0,1,1.0,1,1.0,0,0.0
-86.159,39.771,1247,0,0.0,79,0.06335204490777867,79,0.06335204490777867,1168,0.9366479550922213,19,0,0.0,4,0.21052631578947367,4,0.21052631578947367,15,0.7894736842105263
-86.159,39.7715,4,0,0.0,0,0.0,0,0.0,4,1.0,1,0,0.0,0,0.0,0,0.0,1,1.0
-86.159,39.772,5,0,0.0,0,0.0,0,0.0,5,1.0,1,0,0.0,0,0.0,0,0.0,1,1.0
-86.159,39.7725,604,0,0.0,552,0.9139072847682119,552,0.9139072847682119,52,0.08609271523178808,6,0,0.0,4,0.6666666666666666,4,0.6666666666666666,2,0.3333333333333333
-86.159,39.774,1452,0,0.0,1298,0.8939393939393939,1298,0.8939393939393939,154,0.10606060606060606,34,0,0.0,19,0.5588235294117647,19,0.5588235294117647,15,0.4411764705882353
-86.159,39.775,298,0,0.0,272,0.912751677852349,272,0.912751677852349,26,0.087248322147651,4,0,0.0,2,0.5,2,0.5,2,0.5
-86.159,39.7755,543,0,0.0,435,0.8011049723756906,435,0.8011049723756906,108,0.19889502762430938,24,0,0.0,15,0.625,15,0.625,9,0.375
-86.159,39.776,38,0,0.0,35,0.9210526315789473,35,0.9210526315789473,3,0.07894736842105263,4,0,0.0,3,0.75,3,0.75,1,0.25
-86.159,39.7765,574,0,0.0,507,0.8832752613240418,507,0.8832752613240418,67,0.11672473867595819,9,0,0.0,6,0.6666666666666666,6,0.6666666666666666,3,0.3333333333333333
-86.159,39.777,363,0,0.0,250,0.6887052341597796,250,0.6887052341597796,113,0.31129476584022037,8,0,0.0,5,0.625,5,0.625,3,0.375
-86.159,39.7775,649,0,0.0,418,0.6440677966101694,418,0.6440677966101694,231,0.3559322033898305,24,0,0.0,12,0.5,12,0.5,12,0.5
-86.159,39.778,1288,0,0.0,1145,0.8889751552795031,1145,0.8889751552795031,143,0.1110248447204969,25,0,0.0,16,0.64,16,0.64,9,0.36
-86.159,39.7785,147,0,0.0,118,0.8027210884353742,118,0.8027210884353742,29,0.19727891156462585,7,0,0.0,4,0.5714285714285714,4,0.5714285714285714,3,0.42857142857142855
-86.159,39.779,183,0,0.0,135,0.7377049180327869,135,0.7377049180327869,48,0.26229508196721313,6,0,0.0,3,0.5,3,0.5,3,0.5
-86.159,39.7795,188,0,0.0,181,0.9627659574468085,181,0.9627659574468085,7,0.03723404255319149,6,0,0.0,4,0.6666666666666666,4,0.6666666666666666,2,0.3333333333333333
-86.159,39.78,192,0,0.0,192,1.0,192,1.0,0,0.0,4,0,0.0,4,1.0,4,1.0,0,0.0
-86.159,39.7805,263,0,0.0,263,1.0,263,1.0,0,0.0,4,0,0.0,4,1.0,4,1.0,0,0.0
-86.1585,39.761,1038,0,0.0,0,0.0,0,0.0,1038,1.0,14,0,0.0,0,0.0,0,0.0,14,1.0
-86.1585,39.7615,90,0,0.0,0,0.0,0,0.0,90,1.0,3,0,0.0,0,0.0,0,0.0,3,1.0
-86.1585,39.7625,214,0,0.0,0,0.0,0,0.0,214,1.0,2,0,0.0,0,0.0,0,0.0,2,1.0
-86.1585,39.763,89,0,0.0,0,0.0,0,0.0,89,1.0,1,0,0.0,0,0.0,0,0.0,1,1.0
-86.1585,39.764,49,0,0.0,49,1.0,49,1.0,0,0.0,2,0,0.0,2,1.0,2,1.0,0,0.0
-86.1585,39.7655,630,0,0.0,245,0.3888888888888889,245,0.3888888888888889,385,0.6111111111111112,20,0,0.0,10,0.5,10,0.5,10,0.5
-86.1585,39.7665,315,0,0.0,315,1.0,315,1.0,0,0.0,6,0,0.0,6,1.0,6,1.0,0,0.0
-86.1585,39.767,4555,0,0.0,4465,0.9802414928649835,4465,0.9802414928649835,90,0.019758507135016465,49,0,0.0,39,0.7959183673469388,39,0.7959183673469388,10,0.20408163265306123
-86.1585,39.7675,82,0,0.0,75,0.9146341463414634,75,0.9146341463414634,7,0.08536585365853659,3,0,0.0,2,0.6666666666666666,2,0.6666666666666666,1,0.3333333333333333
-86.1585,39.768,26205,0,0.0,25112,0.9582904025949246,25112,0.9582904025949246,1093,0.04170959740507537,60,0,0.0,42,0.7,42,0.7,18,0.3
-86.1585,39.7685,29772,0,0.0,3280,0.11017063012226253,3280,0.11017063012226253,26492,0.8898293698777374,61,0,0.0,47,0.7704918032786885,47,0.7704918032786885,14,0.22950819672131148
-86.1585,39.769,175,0,0.0,171,0.9771428571428571,171,0.9771428571428571,4,0.022857142857142857,7,0,0.0,6,0.8571428571428571,6,0.8571428571428571,1,0.14285714285714285
-86.1585,39.7695,3290,0,0.0,2233,0.6787234042553192,2233,0.6787234042553192,1057,0.32127659574468087,134,0,0.0,68,0.5074626865671642,68,0.5074626865671642,66,0.4925373134328358
-86.1585,39.77,1846,0,0.0,1249,0.6765980498374865,1249,0.6765980498374865,597,0.32340195016251355,50,0,0.0,24,0.48,24,0.48,26,0.52
-86.1585,39.771,2175,0,0.0,104,0.04781609195402299,104,0.04781609195402299,2071,0.952183908045977,54,0,0.0,5,0.09259259259259259,5,0.09259259259259259,49,0.9074074074074074
-86.1585,39.7725,234,0,0.0,205,0.8760683760683761,205,0.8760683760683761,29,0.12393162393162394,10,0,0.0,5,0.5,5,0.5,5,0.5
-86.1585,39.773,5,0,0.0,0,0.0,0,0.0,5,1.0,1,0,0.0,0,0.0,0,0.0,1,1.0
-86.1585,39.7735,4,0,0.0,0,0.0,0,0.0,4,1.0,1,0,0.0,0,0.0,0,0.0,1,1.0
-86.1585,39.774,899,0,0.0,262,0.2914349276974416,262,0.2914349276974416,637,0.7085650723025584,55,0,0.0,17,0.3090909090909091,17,0.3090909090909091,38,0.6909090909090909
-86.1585,39.775,101,0,0.0,51,0.504950495049505,51,0.504950495049505,50,0.49504950495049505,3,0,0.0,2,0.6666666666666666,2,0.6666666666666666,1,0.3333333333333333
-86.1585,39.7755,437,0,0.0,400,0.9153318077803204,400,0.9153318077803204,37,0.08466819221967964,16,0,0.0,13,0.8125,13,0.8125,3,0.1875
-86.1585,39.7775,96,0,0.0,91,0.9479166666666666,91,0.9479166666666666,5,0.052083333333333336,6,0,0.0,5,0.8333333333333334,5,0.8333333333333334,1,0.16666666666666666
-86.1585,39.778,367,0,0.0,268,0.7302452316076294,268,0.7302452316076294,99,0.26975476839237056,23,0,0.0,15,0.6521739130434783,15,0.6521739130434783,8,0.34782608695652173
-86.158,39.761,4068,0,0.0,367,0.09021632251720747,367,0.09021632251720747,3701,0.9097836774827925,33,0,0.0,7,0.21212121212121213,7,0.21212121212121213,26,0.7878787878787878
-86.158,39.7615,1403,0,0.0,51,0.036350677120456164,51,0.036350677120456164,1352,0.9636493228795439,30,0,0.0,6,0.2,6,0.2,24,0.8
-86.158,39.762,1062,0,0.0,16,0.015065913370998116,16,0.015065913370998116,1046,0.9849340866290018,31,0,0.0,2,0.06451612903225806,2,0.06451612903225806,29,0.9354838709677419
-86.158,39.7625,1900,0,0.0,51,0.026842105263157896,51,0.026842105263157896,1849,0.9731578947368421,27,0,0.0,1,0.037037037037037035,1,0.037037037037037035,26,0.9629629629629629
-86.158,39.763,3425,0,0.0,181,0.05284671532846715,181,0.05284671532846715,3244,0.9471532846715328,31,0,0.0,7,0.22580645161290322,7,0.22580645161290322,24,0.7741935483870968
-86.158,39.7635,2467,0,0.0,1221,0.4949331171463316,1221,0.4949331171463316,1246,0.5050668828536684,54,0,0.0,23,0.42592592592592593,23,0.42592592592592593,31,0.5740740740740741
-86.158,39.764,3035,0,0.0,2535,0.8352553542009885,2535,0.8352553542009885,500,0.16474464579901152,75,0,0.0,40,0.5333333333333333,40,0.5333333333333333,35,0.4666666666666667
-86.158,39.7645,1438,0,0.0,1007,0.700278164116829,1007,0.700278164116829,431,0.2997218358831711,51,0,0.0,30,0.5882352941176471,30,0.5882352941176471,21,0.4117647058823529
-86.158,39.765,1461,0,0.0,868,0.5941136208076659,868,0.5941136208076659,593,0.405886379192334,41,0,0.0,24,0.5853658536585366,24,0.5853658536585366,17,0.4146341463414634
-86.158,39.7655,3125,0,0.0,1875,0.6,1875,0.6,1250,0.4,67,0,0.0,40,0.5970149253731343,40,0.5970149253731343,27,0.40298507462686567
-86.158,39.766,2352,0,0.0,1820,0.7738095238095238,1820,0.7738095238095238,532,0.2261904761904762,36,0,0.0,27,0.75,27,0.75,9,0.25
-86.158,39.7665,3262,0,0.0,2970,0.9104843654199878,2970,0.9104843654199878,292,0.08951563458001226,41,0,0.0,32,0.7804878048780488,32,0.7804878048780488,9,0.21951219512195122
-86.158,39.767,15008,0,0.0,12938,0.8620735607675906,12938,0.8620735607675906,2070,0.13792643923240938,140,0,0.0,100,0.7142857142857143,100,0.7142857142857143,40,0.2857142857142857
-86.158,39.7675,7059,0,0.0,5991,0.8487037824054399,5991,0.8487037824054399,1068,0.15129621759456013,103,0,0.0,71,0.6893203883495146,71,0.6893203883495146,32,0.3106796116504854
-86.158,39.768,2708,0,0.0,2551,0.9420236336779911,2551,0.9420236336779911,157,0.057976366322008865,31,0,0.0,24,0.7741935483870968,24,0.7741935483870968,7,0.22580645161290322
-86.158,39.7685,1173,0,0.0,964,0.8218243819266837,964,0.8218243819266837,209,0.17817561807331628,32,0,0.0,24,0.75,24,0.75,8,0.25
-86.158,39.769,5300,0,0.0,4373,0.8250943396226416,4373,0.8250943396226416,927,0.1749056603773585,76,0,0.0,53,0.6973684210526315,53,0.6973684210526315,23,0.3026315789473684
-86.158,39.7695,11859,0,0.0,9030,0.7614470022767519,9030,0.7614470022767519,2829,0.23855299772324817,142,0,0.0,80,0.5633802816901409,80,0.5633802816901409,62,0.43661971830985913
-86.158,39.77,3818,0,0.0,1252,0.3279203771608172,1252,0.3279203771608172,2566,0.6720796228391828,41,0,0.0,23,0.5609756097560976,23,0.5609756097560976,18,0.43902439024390244
-86.158,39.7705,498,0,0.0,179,0.35943775100401604,179,0.35943775100401604,319,0.6405622489959839,22,0,0.0,7,0.3181818181818182,7,0.3181818181818182,15,0.6818181818181818
-86.158,39.771,2941,0,0.0,284,0.09656579394763685,284,0.09656579394763685,2657,0.9034342060523631,28,0,0.0,7,0.25,7,0.25,21,0.75
-86.158,39.7715,201,0,0.0,112,0.5572139303482587,112,0.5572139303482587,89,0.4427860696517413,6,0,0.0,2,0.3333333333333333,2,0.3333333333333333,4,0.6666666666666666
-86.158,39.7725,3082,0,0.0,2682,0.8702141466580143,2682,0.8702141466580143,400,0.12978585334198572,12,0,0.0,6,0.5,6,0.5,6,0.5
-86.158,39.774,931,0,0.0,103,0.11063372717508056,103,0.11063372717508056,828,0.8893662728249194,26,0,0.0,4,0.15384615384615385,4,0.15384615384615385,22,0.8461538461538461
-86.158,39.775,587,0,0.0,335,0.5706984667802385,335,0.5706984667802385,252,0.4293015332197615,4,0,0.0,3,0.75,3,0.75,1,0.25
-86.158,39.7755,509,0,0.0,458,0.899803536345776,458,0.899803536345776,51,0.10019646365422397,17,0,0.0,14,0.8235294117647058,14,0.8235294117647058,3,0.17647058823529413
-86.158,39.7775,140,0,0.0,138,0.9857142857142858,138,0.9857142857142858,2,0.014285714285714285,3,0,0.0,3,1.0,3,1.0,0,0.0
-86.158,39.778,349,0,0.0,264,0.7564469914040115,264,0.7564469914040115,85,0.24355300859598855,8,0,0.0,7,0.875,7,0.875,1,0.125
-86.1575,39.761,923,0,0.0,125,0.13542795232936078,125,0.13542795232936078,798,0.8645720476706392,25,0,0.0,3,0.12,3,0.12,22,0.88
-86.1575,39.7615,168,0,0.0,0,0.0,0,0.0,168,1.0,4,0,0.0,0,0.0,0,0.0,4,1.0
-86.1575,39.764,252,0,0.0,137,0.5436507936507936,137,0.5436507936507936,115,0.45634920634920634,4,0,0.0,2,0.5,2,0.5,2,0.5
-86.1575,39.765,10,0,0.0,0,0.0,0,0.0,10,1.0,1,0,0.0,0,0.0,0,0.0,1,1.0
-86.1575,39.7655,580,0,0.0,471,0.8120689655172414,471,0.8120689655172414,109,0.1879310344827586,13,0,0.0,8,0.6153846153846154,8,0.6153846153846154,5,0.38461538461538464
-86.1575,39.766,12,0,0.0,10,0.8333333333333334,10,0.8333333333333334,2,0.16666666666666666,2,0,0.0,1,0.5,1,0.5,1,0.5
-86.1575,39.7665,1308,0,0.0,1308,1.0,1308,1.0,0,0.0,11,0,0.0,11,1.0,11,1.0,0,0.0
-86.1575,39.767,14981,0,0.0,14748,0.9844469661571323,14748,0.9844469661571323,233,0.015553033842867632,103,0,0.0,80,0.7766990291262136,80,0.7766990291262136,23,0.22330097087378642
-86.1575,39.7675,17595,0,0.0,17216,0.9784597897129866,17216,0.9784597897129866,379,0.021540210287013355,75,0,0.0,49,0.6533333333333333,49,0.6533333333333333,26,0.3466666666666667
-86.1575,39.768,2572,0,0.0,2332,0.9066874027993779,2332,0.9066874027993779,240,0.09331259720062209,55,0,0.0,40,0.7272727272727273,40,0.7272727272727273,15,0.2727272727272727
-86.1575,39.7685,1530,0,0.0,1429,0.9339869281045752,1429,0.9339869281045752,101,0.06601307189542484,40,0,0.0,33,0.825,33,0.825,7,0.175
-86.1575,39.769,7627,0,0.0,6639,0.870460207158778,6639,0.870460207158778,988,0.12953979284122197,107,0,0.0,70,0.6542056074766355,70,0.6542056074766355,37,0.34579439252336447
-86.1575,39.7695,9203,0,0.0,6235,0.6774964685428665,6235,0.6774964685428665,2968,0.32250353145713356,152,0,0.0,92,0.6052631578947368,92,0.6052631578947368,60,0.39473684210526316
-86.1575,39.77,1731,0,0.0,1361,0.7862507221259387,1361,0.7862507221259387,370,0.21374927787406123,24,0,0.0,18,0.75,18,0.75,6,0.25
-86.1575,39.7705,1094,0,0.0,264,0.2413162705667276,264,0.2413162705667276,830,0.7586837294332724,36,0,0.0,13,0.3611111111111111,13,0.3611111111111111,23,0.6388888888888888
-86.1575,39.771,4300,0,0.0,726,0.16883720930232557,726,0.16883720930232557,3574,0.8311627906976744,49,0,0.0,12,0.24489795918367346,12,0.24489795918367346,37,0.7551020408163265
-86.1575,39.7715,2820,0,0.0,385,0.13652482269503546,385,0.13652482269503546,2435,0.8634751773049646,28,0,0.0,5,0.17857142857142858,5,0.17857142857142858,23,0.8214285714285714
-86.1575,39.772,1219,0,0.0,244,0.20016406890894176,244,0.20016406890894176,975,0.7998359310910582,42,0,0.0,9,0.21428571428571427,9,0.21428571428571427,33,0.7857142857142857
-86.1575,39.7725,1512,0,0.0,171,0.1130952380952381,171,0.1130952380952381,1341,0.8869047619047619,25,0,0.0,5,0.2,5,0.2,20,0.8
-86.1575,39.773,1028,0,0.0,85,0.08268482490272373,85,0.08268482490272373,943,0.9173151750972762,26,0,0.0,2,0.07692307692307693,2,0.07692307692307693,24,0.9230769230769231
-86.1575,39.7735,2877,0,0.0,89,0.030935001737921446,89,0.030935001737921446,2788,0.9690649982620786,27,0,0.0,4,0.14814814814814814,4,0.14814814814814814,23,0.8518518518518519
-86.1575,39.774,3503,0,0.0,220,0.06280331144733085,220,0.06280331144733085,3283,0.9371966885526691,46,0,0.0,6,0.13043478260869565,6,0.13043478260869565,40,0.8695652173913043
-86.1575,39.7745,1086,0,0.0,321,0.2955801104972376,321,0.2955801104972376,765,0.7044198895027625,33,0,0.0,12,0.36363636363636365,12,0.36363636363636365,21,0.6363636363636364
-86.1575,39.775,3149,0,0.0,2306,0.7322959669736424,2306,0.7322959669736424,843,0.2677040330263576,49,0,0.0,28,0.5714285714285714,28,0.5714285714285714,21,0.42857142857142855
-86.1575,39.7755,3113,0,0.0,2356,0.7568262126566013,2356,0.7568262126566013,757,0.24317378734339865,21,0,0.0,18,0.8571428571428571,18,0.8571428571428571,3,0.14285714285714285
-86.1575,39.776,509,0,0.0,426,0.8369351669941061,426,0.8369351669941061,83,0.16306483300589392,9,0,0.0,6,0.6666666666666666,6,0.6666666666666666,3,0.3333333333333333
-86.1575,39.7765,274,0,0.0,190,0.6934306569343066,190,0.6934306569343066,84,0.30656934306569344,8,0,0.0,5,0.625,5,0.625,3,0.375
-86.1575,39.777,360,0,0.0,274,0.7611111111111111,274,0.7611111111111111,86,0.2388888888888889,15,0,0.0,10,0.6666666666666666,10,0.6666666666666666,5,0.3333333333333333
-86.1575,39.7775,4482,0,0.0,4293,0.9578313253012049,4293,0.9578313253012049,189,0.04216867469879518,30,0,0.0,19,0.6333333333333333,19,0.6333333333333333,11,0.36666666666666664
-86.1575,39.778,1242,0,0.0,1136,0.9146537842190016,1136,0.9146537842190016,106,0.0853462157809984,25,0,0.0,17,0.68,17,0.68,8,0.32
-86.1575,39.7785,139,0,0.0,81,0.5827338129496403,81,0.5827338129496403,58,0.4172661870503597,6,0,0.0,3,0.5,3,0.5,3,0.5
-86.1575,39.779,480,0,0.0,87,0.18125,87,0.18125,393,0.81875,4,0,0.0,2,0.5,2,0.5,2,0.5
-86.1575,39.7795,195,0,0.0,80,0.41025641025641024,80,0.41025641025641024,115,0.5897435897435898,7,0,0.0,4,0.5714285714285714,4,0.5714285714285714,3,0.42857142857142855
-86.1575,39.78,93,0,0.0,93,1.0,93,1.0,0,0.0,1,0,0.0,1,1.0,1,1.0,0,0.0
-86.1575,39.7805,98,0,0.0,98,1.0,98,1.0,0,0.0,1,0,0.0,1,1.0,1,1.0,0,0.0
-86.157,39.761,644,0,0.0,19,0.029503105590062112,19,0.029503105590062112,625,0.9704968944099379,16,0,0.0,1,0.0625,1,0.0625,15,0.9375
-86.157,39.7615,19,0,0.0,0,0.0,0,0.0,19,1.0,1,0,0.0,0,0.0,0,0.0,1,1.0
-86.157,39.764,88,0,0.0,69,0.7840909090909091,69,0.7840909090909091,19,0.2159090909090909,8,0,0.0,4,0.5,4,0.5,4,0.5
-86.157,39.7655,482,0,0.0,332,0.6887966804979253,332,0.6887966804979253,150,0.3112033195020747,35,0,0.0,20,0.5714285714285714,20,0.5714285714285714,15,0.42857142857142855
-86.157,39.7665,1212,0,0.0,1186,0.9785478547854786,1186,0.9785478547854786,26,0.02145214521452145,22,0,0.0,17,0.7727272727272727,17,0.7727272727272727,5,0.22727272727272727
-86.157,39.767,6269,0,0.0,6023,0.9607592917530706,6023,0.9607592917530706,246,0.03924070824692934,103,0,0.0,78,0.7572815533980582,78,0.7572815533980582,25,0.24271844660194175
-86.157,39.7675,91,0,0.0,87,0.9560439560439561,87,0.9560439560439561,4,0.04395604395604396,3,0,0.0,2,0.6666666666666666,2,0.6666666666666666,1,0.3333333333333333
-86.157,39.768,4494,0,0.0,3886,0.8647085002225189,3886,0.8647085002225189,608,0.1352914997774811,78,0,0.0,54,0.6923076923076923,54,0.6923076923076923,24,0.3076923076923077
-86.157,39.7685,4167,0,0.0,4028,0.966642668586513,4028,0.966642668586513,139,0.03335733141348692,60,0,0.0,50,0.8333333333333334,50,0.8333333333333334,10,0.16666666666666666
-86.157,39.769,3,0,0.0,3,1.0,3,1.0,0,0.0,1,0,0.0,1,1.0,1,1.0,0,0.0
-86.157,39.7695,4138,0,0.0,2397,0.5792653455775737,2397,0.5792653455775737,1741,0.4207346544224263,91,0,0.0,48,0.5274725274725275,48,0.5274725274725275,43,0.4725274725274725
-86.157,39.77,526,0,0.0,393,0.747148288973384,393,0.747148288973384,133,0.25285171102661597,9,0,0.0,4,0.4444444444444444,4,0.4444444444444444,5,0.5555555555555556
-86.157,39.771,2919,0,0.0,81,0.02774922918807811,81,0.02774922918807811,2838,0.9722507708119219,26,0,0.0,3,0.11538461538461539,3,0.11538461538461539,23,0.8846153846153846
-86.157,39.7725,3261,0,0.0,79,0.024225697638761118,79,0.024225697638761118,3182,0.9757743023612389,5,0,0.0,1,0.2,1,0.2,4,0.8
-86.157,39.7735,43,0,0.0,0,0.0,0,0.0,43,1.0,1,0,0.0,0,0.0,0,0.0,1,1.0
-86.157,39.774,1664,0,0.0,90,0.054086538461538464,90,0.054086538461538464,1574,0.9459134615384616,39,0,0.0,2,0.05128205128205128,2,0.05128205128205128,37,0.9487179487179487
-86.157,39.775,670,0,0.0,471,0.7029850746268657,471,0.7029850746268657,199,0.29701492537313434,11,0,0.0,9,0.8181818181818182,9,0.8181818181818182,2,0.18181818181818182
-86.157,39.7755,916,0,0.0,888,0.9694323144104804,888,0.9694323144104804,28,0.03056768558951965,9,0,0.0,8,0.8888888888888888,8,0.8888888888888888,1,0.1111111111111111
-86.157,39.7775,1547,0,0.0,1491,0.9638009049773756,1491,0.9638009049773756,56,0.03619909502262444,13,0,0.0,9,0.6923076923076923,9,0.6923076923076923,4,0.3076923076923077
-86.157,39.778,609,0,0.0,576,0.9458128078817734,576,0.9458128078817734,33,0.054187192118226604,5,0,0.0,3,0.6,3,0.6,2,0.4
-86.157,39.779,84,0,0.0,0,0.0,0,0.0,84,1.0,3,0,0.0,0,0.0,0,0.0,3,1.0
-86.1565,39.761,2147,0,0.0,330,0.1537028411737308,330,0.1537028411737308,1817,0.8462971588262692,28,0,0.0,4,0.14285714285714285,4,0.14285714285714285,24,0.8571428571428571
-86.1565,39.7615,801,0,0.0,0,0.0,0,0.0,801,1.0,11,0,0.0,0,0.0,0,0.0,11,1.0
-86.1565,39.762,497,0,0.0,0,0.0,0,0.0,497,1.0,19,0,0.0,0,0.0,0,0.0,19,1.0
-86.1565,39.7625,510,0,0.0,0,0.0,0,0.0,510,1.0,7,0,0.0,0,0.0,0,0.0,7,1.0
-86.1565,39.763,158,0,0.0,14,0.08860759493670886,14,0.08860759493670886,144,0.9113924050632911,8,0,0.0,2,0.25,2,0.25,6,0.75
-86.1565,39.7635,28,0,0.0,28,1.0,28,1.0,0,0.0,2,0,0.0,2,1.0,2,1.0,0,0.0
-86.1565,39.764,136,0,0.0,120,0.8823529411764706,120,0.8823529411764706,16,0.11764705882352941,7,0,0.0,4,0.5714285714285714,4,0.5714285714285714,3,0.42857142857142855
-86.1565,39.765,3,0,0.0,3,1.0,3,1.0,0,0.0,1,0,0.0,1,1.0,1,1.0,0,0.0
-86.1565,39.7655,1824,0,0.0,1248,0.6842105263157895,1248,0.6842105263157895,576,0.3157894736842105,24,0,0.0,16,0.6666666666666666,16,0.6666666666666666,8,0.3333333333333333
-86.1565,39.7665,919,0,0.0,838,0.911860718171926,838,0.911860718171926,81,0.088139281828074,36,0,0.0,26,0.7222222222222222,26,0.7222222222222222,10,0.2777777777777778
-86.1565,39.767,6077,0,0.0,5535,0.9108112555537272,5535,0.9108112555537272,542,0.08918874444627284,123,0,0.0,86,0.6991869918699187,86,0.6991869918699187,37,0.3008130081300813
-86.1565,39.7675,520,0,0.0,520,1.0,520,1.0,0,0.0,1,0,0.0,1,1.0,1,1.0,0,0.0
-86.1565,39.768,377,0,0.0,362,0.9602122015915119,362,0.9602122015915119,15,0.03978779840848806,10,0,0.0,7,0.7,7,0.7,3,0.3
-86.1565,39.7685,1530,0,0.0,1505,0.9836601307189542,1505,0.9836601307189542,25,0.016339869281045753,14,0,0.0,11,0.7857142857142857,11,0.7857142857142857,3,0.21428571428571427
-86.1565,39.769,648,0,0.0,648,1.0,648,1.0,0,0.0,4,0,0.0,4,1.0,4,1.0,0,0.0
-86.1565,39.7695,5516,0,0.0,4216,0.7643219724437998,4216,0.7643219724437998,1300,0.23567802755620015,115,0,0.0,67,0.5826086956521739,67,0.5826086956521739,48,0.41739130434782606
-86.1565,39.77,1052,0,0.0,862,0.8193916349809885,862,0.8193916349809885,190,0.1806083650190114,13,0,0.0,9,0.6923076923076923,9,0.6923076923076923,4,0.3076923076923077
-86.1565,39.771,3018,0,0.0,111,0.036779324055666,111,0.036779324055666,2907,0.963220675944334,39,0,0.0,4,0.10256410256410256,4,0.10256410256410256,35,0.8974358974358975
-86.1565,39.7725,261,0,0.0,72,0.27586206896551724,72,0.27586206896551724,189,0.7241379310344828,8,0,0.0,3,0.375,3,0.375,5,0.625
-86.1565,39.7735,31,0,0.0,0,0.0,0,0.0,31,1.0,1,0,0.0,0,0.0,0,0.0,1,1.0
-86.1565,39.774,846,0,0.0,34,0.04018912529550828,34,0.04018912529550828,812,0.9598108747044918,9,0,0.0,1,0.1111111111111111,1,0.1111111111111111,8,0.8888888888888888
-86.1565,39.775,5312,0,0.0,4814,0.90625,4814,0.90625,498,0.09375,7,0,0.0,5,0.7142857142857143,5,0.7142857142857143,2,0.2857142857142857
-86.1565,39.7755,279,0,0.0,147,0.5268817204301075,147,0.5268817204301075,132,0.4731182795698925,21,0,0.0,9,0.42857142857142855,9,0.42857142857142855,12,0.5714285714285714
-86.1565,39.7775,330,0,0.0,268,0.8121212121212121,268,0.8121212121212121,62,0.18787878787878787,17,0,0.0,11,0.6470588235294118,11,0.6470588235294118,6,0.35294117647058826
-86.156,39.761,3741,0,0.0,286,0.0764501470195135,286,0.0764501470195135,3455,0.9235498529804865,32,0,0.0,5,0.15625,5,0.15625,27,0.84375
-86.156,39.7615,591,0,0.0,0,0.0,0,0.0,591,1.0,11,0,0.0,0,0.0,0,0.0,11,1.0
-86.156,39.762,515,0,0.0,0,0.0,0,0.0,515,1.0,15,0,0.0,0,0.0,0,0.0,15,1.0
-86.156,39.7625,466,0,0.0,0,0.0,0,0.0,466,1.0,10,0,0.0,0,0.0,0,0.0,10,1.0
-86.156,39.763,670,0,0.0,29,0.04328358208955224,29,0.04328358208955224,641,0.9567164179104478,19,0,0.0,5,0.2631578947368421,5,0.2631578947368421,14,0.7368421052631579
-86.156,39.7635,823,0,0.0,609,0.7399756986634265,609,0.7399756986634265,214,0.2600243013365735,33,0,0.0,16,0.48484848484848486,16,0.48484848484848486,17,0.5151515151515151
-86.156,39.764,1860,0,0.0,1128,0.6064516129032258,1128,0.6064516129032258,732,0.3935483870967742,72,0,0.0,42,0.5833333333333334,42,0.5833333333333334,30,0.4166666666666667
-86.156,39.7645,2511,0,0.0,2199,0.8757467144563919,2199,0.8757467144563919,312,0.12425328554360812,42,0,0.0,26,0.6190476190476191,26,0.6190476190476191,16,0.38095238095238093
-86.156,39.765,1800,0,0.0,1449,0.805,1449,0.805,351,0.195,23,0,0.0,17,0.7391304347826086,17,0.7391304347826086,6,0.2608695652173913
-86.156,39.7655,4126,0,0.0,3248,0.7872031022782355,3248,0.7872031022782355,878,0.2127968977217644,87,0,0.0,53,0.6091954022988506,53,0.6091954022988506,34,0.39080459770114945
-86.156,39.766,4731,0,0.0,3605,0.761995349820334,3605,0.761995349820334,1126,0.23800465017966604,40,0,0.0,25,0.625,25,0.625,15,0.375
-86.156,39.7665,4001,0,0.0,3879,0.9695076230942264,3879,0.9695076230942264,122,0.030492376905773555,36,0,0.0,31,0.8611111111111112,31,0.8611111111111112,5,0.1388888888888889
-86.156,39.767,10790,0,0.0,10246,0.9495829471733086,10246,0.9495829471733086,544,0.05041705282669138,181,0,0.0,123,0.6795580110497238,123,0.6795580110497238,58,0.32044198895027626
-86.156,39.7675,8712,0,0.0,8277,0.9500688705234159,8277,0.9500688705234159,435,0.04993112947658402,78,0,0.0,60,0.7692307692307693,60,0.7692307692307693,18,0.23076923076923078
-86.156,39.768,8886,0,0.0,8191,0.9217870808012604,8191,0.9217870808012604,695,0.07821291919873959,69,0,0.0,56,0.8115942028985508,56,0.8115942028985508,13,0.18840579710144928
-86.156,39.7685,13017,0,0.0,11327,0.8701697779826381,11327,0.8701697779826381,1690,0.1298302220173619,133,0,0.0,94,0.706766917293233,94,0.706766917293233,39,0.2932330827067669
-86.156,39.769,7383,0,0.0,6779,0.9181904374915346,6779,0.9181904374915346,604,0.0818095625084654,125,0,0.0,80,0.64,80,0.64,45,0.36
-86.156,39.7695,12668,0,0.0,9202,0.7263972213451215,9202,0.7263972213451215,3466,0.2736027786548784,120,0,0.0,77,0.6416666666666667,77,0.6416666666666667,43,0.35833333333333334
-86.156,39.77,3058,0,0.0,2428,0.7939829954218444,2428,0.7939829954218444,630,0.20601700457815567,30,0,0.0,18,0.6,18,0.6,12,0.4
-86.156,39.7705,2525,0,0.0,1471,0.5825742574257425,1471,0.5825742574257425,1054,0.4174257425742574,43,0,0.0,11,0.2558139534883721,11,0.2558139534883721,32,0.7441860465116279
-86.156,39.771,7186,0,0.0,110,0.015307542443640411,110,0.015307542443640411,7076,0.9846924575563596,33,0,0.0,4,0.12121212121212122,4,0.12121212121212122,29,0.8787878787878788
-86.156,39.7715,4566,0,0.0,2,0.0004380201489268506,2,0.0004380201489268506,4564,0.9995619798510732,32,0,0.0,1,0.03125,1,0.03125,31,0.96875
-86.156,39.772,14549,0,0.0,0,0.0,0,0.0,14549,1.0,33,0,0.0,0,0.0,0,0.0,33,1.0
-86.156,39.7725,3185,0,0.0,0,0.0,0,0.0,3185,1.0,23,0,0.0,0,0.0,0,0.0,23,1.0
-86.156,39.773,3788,0,0.0,0,0.0,0,0.0,3788,1.0,32,0,0.0,0,0.0,0,0.0,32,1.0
-86.156,39.7735,2573,0,0.0,0,0.0,0,0.0,2573,1.0,17,0,0.0,0,0.0,0,0.0,17,1.0
-86.156,39.774,3363,0,0.0,519,0.1543264942016057,519,0.1543264942016057,2844,0.8456735057983943,29,0,0.0,7,0.2413793103448276,7,0.2413793103448276,22,0.7586206896551724
-86.156,39.7745,1829,0,0.0,1182,0.6462547840349918,1182,0.6462547840349918,647,0.3537452159650082,39,0,0.0,12,0.3076923076923077,12,0.3076923076923077,27,0.6923076923076923
-86.156,39.775,4102,0,0.0,1321,0.3220380302291565,1321,0.3220380302291565,2781,0.6779619697708434,24,0,0.0,8,0.3333333333333333,8,0.3333333333333333,16,0.6666666666666666
-86.156,39.7755,1025,0,0.0,274,0.2673170731707317,274,0.2673170731707317,751,0.7326829268292683,14,0,0.0,8,0.5714285714285714,8,0.5714285714285714,6,0.42857142857142855
-86.156,39.776,4,0,0.0,4,1.0,4,1.0,0,0.0,2,0,0.0,2,1.0,2,1.0,0,0.0
-86.156,39.7765,1,0,0.0,1,1.0,1,1.0,0,0.0,1,0,0.0,1,1.0,1,1.0,0,0.0
-86.156,39.777,1,0,0.0,1,1.0,1,1.0,0,0.0,1,0,0.0,1,1.0,1,1.0,0,0.0
-86.156,39.7775,835,0,0.0,791,0.9473053892215569,791,0.9473053892215569,44,0.05269461077844311,8,0,0.0,6,0.75,6,0.75,2,0.25
-86.156,39.778,17,0,0.0,17,1.0,17,1.0,0,0.0,2,0,0.0,2,1.0,2,1.0,0,0.0
-86.1555,39.761,1357,0,0.0,47,0.034635224760501106,47,0.034635224760501106,1310,0.9653647752394989,34,0,0.0,3,0.08823529411764706,3,0.08823529411764706,31,0.9117647058823529
-86.1555,39.7655,421,0,0.0,382,0.9073634204275535,382,0.9073634204275535,39,0.09263657957244656,10,0,0.0,8,0.8,8,0.8,2,0.2
-86.1555,39.7665,1261,0,0.0,1221,0.9682791435368755,1221,0.9682791435368755,40,0.0317208564631245,28,0,0.0,19,0.6785714285714286,19,0.6785714285714286,9,0.32142857142857145
-86.1555,39.767,2611,0,0.0,2485,0.9517426273458445,2485,0.9517426273458445,126,0.04825737265415549,46,0,0.0,31,0.6739130434782609,31,0.6739130434782609,15,0.32608695652173914
-86.1555,39.768,401,0,0.0,401,1.0,401,1.0,0,0.0,2,0,0.0,2,1.0,2,1.0,0,0.0
-86.1555,39.7685,184,0,0.0,184,1.0,184,1.0,0,0.0,2,0,0.0,2,1.0,2,1.0,0,0.0
-86.1555,39.769,486,0,0.0,486,1.0,486,1.0,0,0.0,3,0,0.0,3,1.0,3,1.0,0,0.0
-86.1555,39.7695,1048,0,0.0,837,0.7986641221374046,837,0.7986641221374046,211,0.2013358778625954,14,0,0.0,11,0.7857142857142857,11,0.7857142857142857,3,0.21428571428571427
-86.1555,39.771,11607,0,0.0,34,0.0029292668217454983,34,0.0029292668217454983,11573,0.9970707331782545,12,0,0.0,1,0.08333333333333333,1,0.08333333333333333,11,0.9166666666666666
-86.1555,39.7715,304,0,0.0,0,0.0,0,0.0,304,1.0,5,0,0.0,0,0.0,0,0.0,5,1.0
-86.1555,39.772,2737,0,0.0,0,0.0,0,0.0,2737,1.0,14,0,0.0,0,0.0,0,0.0,14,1.0
-86.1555,39.7725,2288,0,0.0,24,0.01048951048951049,24,0.01048951048951049,2264,0.9895104895104895,10,0,0.0,1,0.1,1,0.1,9,0.9
-86.1555,39.773,2836,0,0.0,0,0.0,0,0.0,2836,1.0,24,0,0.0,0,0.0,0,0.0,24,1.0
-86.1555,39.7735,4319,0,0.0,244,0.05649455892567724,244,0.05649455892567724,4075,0.9435054410743228,21,0,0.0,2,0.09523809523809523,2,0.09523809523809523,19,0.9047619047619048
-86.1555,39.774,6749,0,0.0,1319,0.19543636094236183,1319,0.19543636094236183,5430,0.8045636390576382,78,0,0.0,31,0.3974358974358974,31,0.3974358974358974,47,0.6025641025641025
-86.1555,39.7745,3443,0,0.0,1905,0.5532965437118792,1905,0.5532965437118792,1538,0.4467034562881208,51,0,0.0,16,0.3137254901960784,16,0.3137254901960784,35,0.6862745098039216
-86.1555,39.775,7159,0,0.0,3322,0.4640312892862132,3322,0.4640312892862132,3837,0.5359687107137868,75,0,0.0,26,0.3466666666666667,26,0.3466666666666667,49,0.6533333333333333
-86.1555,39.7755,2985,0,0.0,2406,0.8060301507537688,2406,0.8060301507537688,579,0.19396984924623115,34,0,0.0,21,0.6176470588235294,21,0.6176470588235294,13,0.38235294117647056
-86.1555,39.776,527,0,0.0,522,0.9905123339658444,522,0.9905123339658444,5,0.009487666034155597,17,0,0.0,15,0.8823529411764706,15,0.8823529411764706,2,0.11764705882352941
-86.1555,39.7765,719,0,0.0,660,0.9179415855354659,660,0.9179415855354659,59,0.08205841446453407,23,0,0.0,14,0.6086956521739131,14,0.6086956521739131,9,0.391304347826087
-86.1555,39.777,281,0,0.0,253,0.900355871886121,253,0.900355871886121,28,0.099644128113879,11,0,0.0,9,0.8181818181818182,9,0.8181818181818182,2,0.18181818181818182
-86.1555,39.7775,1508,0,0.0,1251,0.8295755968169761,1251,0.8295755968169761,257,0.17042440318302388,11,0,0.0,10,0.9090909090909091,10,0.9090909090909091,1,0.09090909090909091
-86.1555,39.778,600,0,0.0,597,0.995,597,0.995,3,0.005,8,0,0.0,7,0.875,7,0.875,1,0.125
-86.1555,39.7785,125,0,0.0,125,1.0,125,1.0,0,0.0,3,0,0.0,3,1.0,3,1.0,0,0.0
-86.1555,39.779,132,0,0.0,125,0.946969696969697,125,0.946969696969697,7,0.05303030303030303,7,0,0.0,5,0.7142857142857143,5,0.7142857142857143,2,0.2857142857142857
-86.1555,39.7795,156,0,0.0,141,0.9038461538461539,141,0.9038461538461539,15,0.09615384615384616,8,0,0.0,5,0.625,5,0.625,3,0.375
-86.1555,39.78,1336,0,0.0,1286,0.9625748502994012,1286,0.9625748502994012,50,0.0374251497005988,19,0,0.0,11,0.5789473684210527,11,0.5789473684210527,8,0.42105263157894735
-86.1555,39.7805,467,0,0.0,412,0.8822269807280514,412,0.8822269807280514,55,0.11777301927194861,3,0,0.0,1,0.3333333333333333,1,0.3333333333333333,2,0.6666666666666666
-86.155,39.761,2736,0,0.0,290,0.10599415204678363,290,0.10599415204678363,2446,0.8940058479532164,40,0,0.0,5,0.125,5,0.125,35,0.875
-86.155,39.7655,539,0,0.0,413,0.7662337662337663,413,0.7662337662337663,126,0.23376623376623376,24,0,0.0,15,0.625,15,0.625,9,0.375
-86.155,39.7665,884,0,0.0,866,0.9796380090497737,866,0.9796380090497737,18,0.020361990950226245,27,0,0.0,21,0.7777777777777778,21,0.7777777777777778,6,0.2222222222222222
-86.155,39.767,2098,0,0.0,2088,0.9952335557673975,2088,0.9952335557673975,10,0.004766444232602479,21,0,0.0,17,0.8095238095238095,17,0.8095238095238095,4,0.19047619047619047
-86.155,39.768,408,0,0.0,408,1.0,408,1.0,0,0.0,1,0,0.0,1,1.0,1,1.0,0,0.0
-86.155,39.7695,788,0,0.0,391,0.49619289340101524,391,0.49619289340101524,397,0.5038071065989848,19,0,0.0,11,0.5789473684210527,11,0.5789473684210527,8,0.42105263157894735
-86.155,39.771,6401,0,0.0,218,0.03405717856584908,218,0.03405717856584908,6183,0.9659428214341509,26,0,0.0,4,0.15384615384615385,4,0.15384615384615385,22,0.8461538461538461
-86.155,39.7725,133,0,0.0,69,0.518796992481203,69,0.518796992481203,64,0.48120300751879697,4,0,0.0,2,0.5,2,0.5,2,0.5
-86.155,39.7735,39,0,0.0,16,0.41025641025641024,16,0.41025641025641024,23,0.5897435897435898,3,0,0.0,1,0.3333333333333333,1,0.3333333333333333,2,0.6666666666666666
-86.155,39.774,872,0,0.0,261,0.2993119266055046,261,0.2993119266055046,611,0.7006880733944955,58,0,0.0,19,0.3275862068965517,19,0.3275862068965517,39,0.6724137931034483
-86.155,39.775,2428,0,0.0,2196,0.9044481054365733,2196,0.9044481054365733,232,0.09555189456342669,45,0,0.0,29,0.6444444444444445,29,0.6444444444444445,16,0.35555555555555557
-86.155,39.7755,291,0,0.0,278,0.9553264604810997,278,0.9553264604810997,13,0.044673539518900345,5,0,0.0,4,0.8,4,0.8,1,0.2
-86.155,39.776,1,0,0.0,0,0.0,0,0.0,1,1.0,1,0,0.0,0,0.0,0,0.0,1,1.0
-86.155,39.7765,95,0,0.0,93,0.9789473684210527,93,0.9789473684210527,2,0.021052631578947368,4,0,0.0,3,0.75,3,0.75,1,0.25
-86.155,39.777,3,0,0.0,3,1.0,3,1.0,0,0.0,1,0,0.0,1,1.0,1,1.0,0,0.0
-86.155,39.7775,311,0,0.0,255,0.819935691318328,255,0.819935691318328,56,0.18006430868167203,14,0,0.0,9,0.6428571428571429,9,0.6428571428571429,5,0.35714285714285715
-86.155,39.78,114,0,0.0,114,1.0,114,1.0,0,0.0,2,0,0.0,2,1.0,2,1.0,0,0.0
-86.1545,39.761,3788,0,0.0,134,0.03537486800422387,134,0.03537486800422387,3654,0.9646251319957762,38,0,0.0,4,0.10526315789473684,4,0.10526315789473684,34,0.8947368421052632
-86.1545,39.7615,915,0,0.0,29,0.03169398907103825,29,0.03169398907103825,886,0.9683060109289617,17,0,0.0,1,0.058823529411764705,1,0.058823529411764705,16,0.9411764705882353
-86.1545,39.762,1766,0,0.0,0,0.0,0,0.0,1766,1.0,33,0,0.0,0,0.0,0,0.0,33,1.0
-86.1545,39.7625,1628,0,0.0,0,0.0,0,0.0,1628,1.0,8,0,0.0,0,0.0,0,0.0,8,1.0
-86.1545,39.763,940,0,0.0,0,0.0,0,0.0,940,1.0,8,0,0.0,0,0.0,0,0.0,8,1.0
-86.1545,39.7635,1228,0,0.0,672,0.5472312703583062,672,0.5472312703583062,556,0.4527687296416938,52,0,0.0,18,0.34615384615384615,18,0.34615384615384615,34,0.6538461538461539
-86.1545,39.764,980,0,0.0,980,1.0,980,1.0,0,0.0,31,0,0.0,31,1.0,31,1.0,0,0.0
-86.1545,39.7645,2076,0,0.0,2076,1.0,2076,1.0,0,0.0,12,0,0.0,12,1.0,12,1.0,0,0.0
-86.1545,39.765,4668,0,0.0,4601,0.9856469580119965,4601,0.9856469580119965,67,0.014353041988003428,52,0,0.0,36,0.6923076923076923,36,0.6923076923076923,16,0.3076923076923077
-86.1545,39.7655,4864,0,0.0,4504,0.9259868421052632,4504,0.9259868421052632,360,0.07401315789473684,34,0,0.0,30,0.8823529411764706,30,0.8823529411764706,4,0.11764705882352941
-86.1545,39.766,6444,0,0.0,5518,0.856300434512725,5518,0.856300434512725,926,0.14369956548727497,61,0,0.0,41,0.6721311475409836,41,0.6721311475409836,20,0.32786885245901637
-86.1545,39.7665,3893,0,0.0,3800,0.9761109684048291,3800,0.9761109684048291,93,0.02388903159517082,71,0,0.0,54,0.7605633802816901,54,0.7605633802816901,17,0.23943661971830985
-86.1545,39.767,2972,0,0.0,2972,1.0,2972,1.0,0,0.0,22,0,0.0,22,1.0,22,1.0,0,0.0
-86.1545,39.7675,100,0,0.0,98,0.98,98,0.98,2,0.02,8,0,0.0,7,0.875,7,0.875,1,0.125
-86.1545,39.768,47,0,0.0,41,0.8723404255319149,41,0.8723404255319149,6,0.1276595744680851,3,0,0.0,2,0.6666666666666666,2,0.6666666666666666,1,0.3333333333333333
-86.1545,39.7685,256,0,0.0,256,1.0,256,1.0,0,0.0,2,0,0.0,2,1.0,2,1.0,0,0.0
-86.1545,39.769,189,0,0.0,187,0.9894179894179894,187,0.9894179894179894,2,0.010582010582010581,4,0,0.0,3,0.75,3,0.75,1,0.25
-86.1545,39.7695,3011,0,0.0,1920,0.6376619063434075,1920,0.6376619063434075,1091,0.3623380936565925,44,0,0.0,23,0.5227272727272727,23,0.5227272727272727,21,0.4772727272727273
-86.1545,39.77,28,0,0.0,28,1.0,28,1.0,0,0.0,2,0,0.0,2,1.0,2,1.0,0,0.0
-86.1545,39.771,7804,0,0.0,5029,0.644413121476166,5029,0.644413121476166,2775,0.3555868785238339,107,0,0.0,50,0.4672897196261682,50,0.4672897196261682,57,0.5327102803738317
-86.1545,39.7725,142,0,0.0,142,1.0,142,1.0,0,0.0,1,0,0.0,1,1.0,1,1.0,0,0.0
-86.1545,39.7735,62,0,0.0,0,0.0,0,0.0,62,1.0,1,0,0.0,0,0.0,0,0.0,1,1.0
-86.1545,39.774,750,0,0.0,29,0.03866666666666667,29,0.03866666666666667,721,0.9613333333333334,11,0,0.0,1,0.09090909090909091,1,0.09090909090909091,10,0.9090909090909091
-86.1545,39.775,875,0,0.0,710,0.8114285714285714,710,0.8114285714285714,165,0.18857142857142858,24,0,0.0,18,0.75,18,0.75,6,0.25
-86.1545,39.7755,132,0,0.0,132,1.0,132,1.0,0,0.0,5,0,0.0,5,1.0,5,1.0,0,0.0
-86.1545,39.7765,96,0,0.0,25,0.2604166666666667,25,0.2604166666666667,71,0.7395833333333334,9,0,0.0,3,0.3333333333333333,3,0.3333333333333333,6,0.6666666666666666
-86.1545,39.777,4,0,0.0,3,0.75,3,0.75,1,0.25,2,0,0.0,1,0.5,1,0.5,1,0.5
-86.1545,39.7775,262,0,0.0,225,0.8587786259541985,225,0.8587786259541985,37,0.14122137404580154,9,0,0.0,7,0.7777777777777778,7,0.7777777777777778,2,0.2222222222222222
-86.1545,39.778,6,0,0.0,1,0.16666666666666666,1,0.16666666666666666,5,0.8333333333333334,2,0,0.0,1,0.5,1,0.5,1,0.5
-86.1545,39.78,95,0,0.0,95,1.0,95,1.0,0,0.0,2,0,0.0,2,1.0,2,1.0,0,0.0
-86.154,39.761,1746,0,0.0,188,0.10767468499427263,188,0.10767468499427263,1558,0.8923253150057274,17,0,0.0,5,0.29411764705882354,5,0.29411764705882354,12,0.7058823529411765
-86.154,39.764,54,0,0.0,54,1.0,54,1.0,0,0.0,3,0,0.0,3,1.0,3,1.0,0,0.0
-86.154,39.7645,241,0,0.0,238,0.9875518672199171,238,0.9875518672199171,3,0.012448132780082987,5,0,0.0,4,0.8,4,0.8,1,0.2
-86.154,39.765,431,0,0.0,427,0.9907192575406032,427,0.9907192575406032,4,0.009280742459396751,9,0,0.0,8,0.8888888888888888,8,0.8888888888888888,1,0.1111111111111111
-86.154,39.7655,49,0,0.0,49,1.0,49,1.0,0,0.0,2,0,0.0,2,1.0,2,1.0,0,0.0
-86.154,39.7665,1786,0,0.0,1786,1.0,1786,1.0,0,0.0,16,0,0.0,16,1.0,16,1.0,0,0.0
-86.154,39.767,2069,0,0.0,2063,0.9971000483325277,2063,0.9971000483325277,6,0.0028999516674722086,23,0,0.0,22,0.9565217391304348,22,0.9565217391304348,1,0.043478260869565216
-86.154,39.7675,1427,0,0.0,1280,0.8969866853538893,1280,0.8969866853538893,147,0.10301331464611072,64,0,0.0,45,0.703125,45,0.703125,19,0.296875
-86.154,39.768,1328,0,0.0,1310,0.9864457831325302,1310,0.9864457831325302,18,0.01355421686746988,21,0,0.0,16,0.7619047619047619,16,0.7619047619047619,5,0.23809523809523808
-86.154,39.7685,2728,0,0.0,2699,0.9893695014662757,2699,0.9893695014662757,29,0.01063049853372434,20,0,0.0,17,0.85,17,0.85,3,0.15
-86.154,39.769,3108,0,0.0,2497,0.8034105534105535,2497,0.8034105534105535,611,0.19658944658944658,49,0,0.0,28,0.5714285714285714,28,0.5714285714285714,21,0.42857142857142855
-86.154,39.7695,3804,0,0.0,2975,0.7820715036803365,2975,0.7820715036803365,829,0.21792849631966352,52,0,0.0,35,0.6730769230769231,35,0.6730769230769231,17,0.3269230769230769
-86.154,39.77,1698,0,0.0,1551,0.9134275618374559,1551,0.9134275618374559,147,0.08657243816254417,28,0,0.0,23,0.8214285714285714,23,0.8214285714285714,5,0.17857142857142858
-86.154,39.7705,1657,0,0.0,1408,0.8497284248642124,1408,0.8497284248642124,249,0.15027157513578757,64,0,0.0,43,0.671875,43,0.671875,21,0.328125
-86.154,39.771,3937,0,0.0,3665,0.9309118618237237,3665,0.9309118618237237,272,0.06908813817627635,97,0,0.0,73,0.7525773195876289,73,0.7525773195876289,24,0.24742268041237114
-86.154,39.7715,1904,0,0.0,1813,0.9522058823529411,1813,0.9522058823529411,91,0.04779411764705882,50,0,0.0,38,0.76,38,0.76,12,0.24
-86.154,39.772,3168,0,0.0,2892,0.9128787878787878,2892,0.9128787878787878,276,0.08712121212121213,75,0,0.0,49,0.6533333333333333,49,0.6533333333333333,26,0.3466666666666667
-86.154,39.7725,1594,0,0.0,1432,0.8983688833124216,1432,0.8983688833124216,162,0.10163111668757842,34,0,0.0,26,0.7647058823529411,26,0.7647058823529411,8,0.23529411764705882
-86.154,39.773,4033,0,0.0,3548,0.8797421274485495,3548,0.8797421274485495,485,0.12025787255145054,41,0,0.0,30,0.7317073170731707,30,0.7317073170731707,11,0.2682926829268293
-86.154,39.7735,3653,0,0.0,499,0.13660005474952094,499,0.13660005474952094,3154,0.863399945250479,46,0,0.0,22,0.4782608695652174,22,0.4782608695652174,24,0.5217391304347826
-86.154,39.774,2451,0,0.0,43,0.017543859649122806,43,0.017543859649122806,2408,0.9824561403508771,14,0,0.0,1,0.07142857142857142,1,0.07142857142857142,13,0.9285714285714286
-86.154,39.7745,1304,0,0.0,0,0.0,0,0.0,1304,1.0,8,0,0.0,0,0.0,0,0.0,8,1.0
-86.154,39.775,2916,0,0.0,1448,0.49657064471879286,1448,0.49657064471879286,1468,0.5034293552812071,106,0,0.0,41,0.3867924528301887,41,0.3867924528301887,65,0.6132075471698113
-86.154,39.7755,1057,0,0.0,820,0.7757805108798487,820,0.7757805108798487,237,0.22421948912015138,32,0,0.0,16,0.5,16,0.5,16,0.5
-86.154,39.776,688,0,0.0,14,0.020348837209302327,14,0.020348837209302327,674,0.9796511627906976,10,0,0.0,2,0.2,2,0.2,8,0.8
-86.154,39.7765,1795,0,0.0,60,0.033426183844011144,60,0.033426183844011144,1735,0.9665738161559888,10,0,0.0,2,0.2,2,0.2,8,0.8
-86.154,39.777,360,0,0.0,75,0.20833333333333334,75,0.20833333333333334,285,0.7916666666666666,9,0,0.0,2,0.2222222222222222,2,0.2222222222222222,7,0.7777777777777778
-86.154,39.7775,812,0,0.0,599,0.7376847290640394,599,0.7376847290640394,213,0.2623152709359606,29,0,0.0,13,0.4482758620689655,13,0.4482758620689655,16,0.5517241379310345
-86.154,39.778,153,0,0.0,88,0.5751633986928104,88,0.5751633986928104,65,0.42483660130718953,6,0,0.0,4,0.6666666666666666,4,0.6666666666666666,2,0.3333333333333333
-86.154,39.7785,118,0,0.0,42,0.3559322033898305,42,0.3559322033898305,76,0.6440677966101694,6,0,0.0,2,0.3333333333333333,2,0.3333333333333333,4,0.6666666666666666
-86.154,39.779,120,0,0.0,120,1.0,120,1.0,0,0.0,2,0,0.0,2,1.0,2,1.0,0,0.0
-86.154,39.7795,152,0,0.0,152,1.0,152,1.0,0,0.0,2,0,0.0,2,1.0,2,1.0,0,0.0
-86.154,39.78,163,0,0.0,163,1.0,163,1.0,0,0.0,2,0,0.0,2,1.0,2,1.0,0,0.0
-86.1535,39.761,316,0,0.0,19,0.060126582278481014,19,0.060126582278481014,297,0.939873417721519,17,0,0.0,4,0.23529411764705882,4,0.23529411764705882,13,0.7647058823529411
-86.1535,39.7645,24,0,0.0,24,1.0,24,1.0,0,0.0,1,0,0.0,1,1.0,1,1.0,0,0.0
-86.1535,39.765,81,0,0.0,75,0.9259259259259259,75,0.9259259259259259,6,0.07407407407407407,3,0,0.0,2,0.6666666666666666,2,0.6666666666666666,1,0.3333333333333333
-86.1535,39.7655,35,0,0.0,35,1.0,35,1.0,0,0.0,2,0,0.0,2,1.0,2,1.0,0,0.0
-86.1535,39.7665,4827,0,0.0,4720,0.9778330225813134,4720,0.9778330225813134,107,0.022166977418686555,34,0,0.0,24,0.7058823529411765,24,0.7058823529411765,10,0.29411764705882354
-86.1535,39.767,456,0,0.0,423,0.9276315789473685,423,0.9276315789473685,33,0.07236842105263158,22,0,0.0,14,0.6363636363636364,14,0.6363636363636364,8,0.36363636363636365
-86.1535,39.7695,743,0,0.0,556,0.7483176312247645,556,0.7483176312247645,187,0.25168236877523553,32,0,0.0,16,0.5,16,0.5,16,0.5
-86.1535,39.771,1173,0,0.0,1017,0.8670076726342711,1017,0.8670076726342711,156,0.1329923273657289,63,0,0.0,40,0.6349206349206349,40,0.6349206349206349,23,0.36507936507936506
-86.1535,39.7725,4991,0,0.0,4912,0.9841715087156883,4912,0.9841715087156883,79,0.01582849128431176,9,0,0.0,6,0.6666666666666666,6,0.6666666666666666,3,0.3333333333333333
-86.1535,39.7735,624,0,0.0,65,0.10416666666666667,65,0.10416666666666667,559,0.8958333333333334,13,0,0.0,6,0.46153846153846156,6,0.46153846153846156,7,0.5384615384615384
-86.1535,39.774,3214,0,0.0,538,0.16739265712507778,538,0.16739265712507778,2676,0.8326073428749222,31,0,0.0,12,0.3870967741935484,12,0.3870967741935484,19,0.6129032258064516
-86.1535,39.7745,31,0,0.0,31,1.0,31,1.0,0,0.0,2,0,0.0,2,1.0,2,1.0,0,0.0
-86.1535,39.775,1909,0,0.0,1769,0.926663174436878,1769,0.926663174436878,140,0.07333682556312206,24,0,0.0,20,0.8333333333333334,20,0.8333333333333334,4,0.16666666666666666
-86.1535,39.7755,1729,0,0.0,1729,1.0,1729,1.0,0,0.0,3,0,0.0,3,1.0,3,1.0,0,0.0
-86.1535,39.776,103,0,0.0,91,0.883495145631068,91,0.883495145631068,12,0.11650485436893204,2,0,0.0,1,0.5,1,0.5,1,0.5
-86.1535,39.7765,312,0,0.0,246,0.7884615384615384,246,0.7884615384615384,66,0.21153846153846154,4,0,0.0,3,0.75,3,0.75,1,0.25
-86.1535,39.777,115,0,0.0,96,0.8347826086956521,96,0.8347826086956521,19,0.16521739130434782,4,0,0.0,2,0.5,2,0.5,2,0.5
-86.1535,39.7775,1403,0,0.0,1356,0.9665003563791874,1356,0.9665003563791874,47,0.03349964362081254,19,0,0.0,13,0.6842105263157895,13,0.6842105263157895,6,0.3157894736842105
-86.1535,39.778,6,0,0.0,4,0.6666666666666666,4,0.6666666666666666,2,0.3333333333333333,2,0,0.0,1,0.5,1,0.5,1,0.5
-86.1535,39.7785,71,0,0.0,71,1.0,71,1.0,0,0.0,2,0,0.0,2,1.0,2,1.0,0,0.0
-86.1535,39.779,62,0,0.0,33,0.532258064516129,33,0.532258064516129,29,0.46774193548387094,2,0,0.0,1,0.5,1,0.5,1,0.5
-86.1535,39.7795,51,0,0.0,0,0.0,0,0.0,51,1.0,1,0,0.0,0,0.0,0,0.0,1,1.0
-86.1535,39.78,52,0,0.0,46,0.8846153846153846,46,0.8846153846153846,6,0.11538461538461539,3,0,0.0,1,0.3333333333333333,1,0.3333333333333333,2,0.6666666666666666
-86.1535,39.7805,66,0,0.0,61,0.9242424242424242,61,0.9242424242424242,5,0.07575757575757576,3,0,0.0,2,0.6666666666666666,2,0.6666666666666666,1,0.3333333333333333
-86.153,39.761,392,0,0.0,30,0.07653061224489796,30,0.07653061224489796,362,0.923469387755102,11,0,0.0,1,0.09090909090909091,1,0.09090909090909091,10,0.9090909090909091
-86.153,39.764,13,0,0.0,13,1.0,13,1.0,0,0.0,1,0,0.0,1,1.0,1,1.0,0,0.0
-86.153,39.7645,53,0,0.0,53,1.0,53,1.0,0,0.0,1,0,0.0,1,1.0,1,1.0,0,0.0
-86.153,39.765,93,0,0.0,93,1.0,93,1.0,0,0.0,2,0,0.0,2,1.0,2,1.0,0,0.0
-86.153,39.7655,61,0,0.0,61,1.0,61,1.0,0,0.0,2,0,0.0,2,1.0,2,1.0,0,0.0
-86.153,39.7665,5264,0,0.0,5206,0.9889817629179332,5206,0.9889817629179332,58,0.011018237082066869,26,0,0.0,19,0.7307692307692307,19,0.7307692307692307,7,0.2692307692307692
-86.153,39.767,286,0,0.0,285,0.9965034965034965,285,0.9965034965034965,1,0.0034965034965034965,5,0,0.0,4,0.8,4,0.8,1,0.2
-86.153,39.7695,669,0,0.0,190,0.28400597907324365,190,0.28400597907324365,479,0.7159940209267563,30,0,0.0,13,0.43333333333333335,13,0.43333333333333335,17,0.5666666666666667
-86.153,39.771,1156,0,0.0,1028,0.889273356401384,1028,0.889273356401384,128,0.11072664359861592,41,0,0.0,28,0.6829268292682927,28,0.6829268292682927,13,0.3170731707317073
-86.153,39.7725,334,0,0.0,275,0.8233532934131736,275,0.8233532934131736,59,0.17664670658682635,4,0,0.0,3,0.75,3,0.75,1,0.25
-86.153,39.7735,4022,0,0.0,2941,0.7312282446544008,2941,0.7312282446544008,1081,0.2687717553455992,39,0,0.0,24,0.6153846153846154,24,0.6153846153846154,15,0.38461538461538464
-86.153,39.774,649,0,0.0,549,0.8459167950693375,549,0.8459167950693375,100,0.15408320493066255,25,0,0.0,15,0.6,15,0.6,10,0.4
-86.153,39.7745,37,0,0.0,0,0.0,0,0.0,37,1.0,1,0,0.0,0,0.0,0,0.0,1,1.0
-86.153,39.775,1010,0,0.0,657,0.6504950495049505,657,0.6504950495049505,353,0.3495049504950495,29,0,0.0,17,0.5862068965517241,17,0.5862068965517241,12,0.41379310344827586
-86.153,39.7755,25,0,0.0,21,0.84,21,0.84,4,0.16,4,0,0.0,3,0.75,3,0.75,1,0.25
-86.153,39.7775,1084,0,0.0,1010,0.9317343173431735,1010,0.9317343173431735,74,0.06826568265682657,17,0,0.0,12,0.7058823529411765,12,0.7058823529411765,5,0.29411764705882354
-86.153,39.7785,5,0,0.0,2,0.4,2,0.4,3,0.6,2,0,0.0,1,0.5,1,0.5,1,0.5
-86.1525,39.761,1097,0,0.0,33,0.0300820419325433,33,0.0300820419325433,1064,0.9699179580674567,10,0,0.0,1,0.1,1,0.1,9,0.9
-86.1525,39.7615,135,0,0.0,57,0.4222222222222222,57,0.4222222222222222,78,0.5777777777777777,6,0,0.0,2,0.3333333333333333,2,0.3333333333333333,4,0.6666666666666666
-86.1525,39.762,108,0,0.0,108,1.0,108,1.0,0,0.0,1,0,0.0,1,1.0,1,1.0,0,0.0
-86.1525,39.7625,161,0,0.0,161,1.0,161,1.0,0,0.0,1,0,0.0,1,1.0,1,1.0,0,0.0
-86.1525,39.7635,1,0,0.0,1,1.0,1,1.0,0,0.0,1,0,0.0,1,1.0,1,1.0,0,0.0
-86.1525,39.764,62,0,0.0,62,1.0,62,1.0,0,0.0,1,0,0.0,1,1.0,1,1.0,0,0.0
-86.1525,39.765,132,0,0.0,123,0.9318181818181818,123,0.9318181818181818,9,0.06818181818181818,5,0,0.0,3,0.6,3,0.6,2,0.4
-86.1525,39.7655,8223,0,0.0,7875,0.9576796789492886,7875,0.9576796789492886,348,0.04232032105071142,79,0,0.0,51,0.6455696202531646,51,0.6455696202531646,28,0.35443037974683544
-86.1525,39.766,2962,0,0.0,2874,0.9702903443619176,2874,0.9702903443619176,88,0.029709655638082377,63,0,0.0,43,0.6825396825396826,43,0.6825396825396826,20,0.31746031746031744
-86.1525,39.7665,5991,0,0.0,5958,0.9944917376064096,5958,0.9944917376064096,33,0.005508262393590386,43,0,0.0,40,0.9302325581395349,40,0.9302325581395349,3,0.06976744186046512
-86.1525,39.767,5832,0,0.0,5722,0.9811385459533608,5722,0.9811385459533608,110,0.01886145404663923,85,0,0.0,59,0.6941176470588235,59,0.6941176470588235,26,0.3058823529411765
-86.1525,39.7675,1818,0,0.0,1763,0.9697469746974697,1763,0.9697469746974697,55,0.030253025302530254,53,0,0.0,39,0.7358490566037735,39,0.7358490566037735,14,0.2641509433962264
-86.1525,39.768,2210,0,0.0,2194,0.9927601809954751,2194,0.9927601809954751,16,0.007239819004524887,49,0,0.0,45,0.9183673469387755,45,0.9183673469387755,4,0.08163265306122448
-86.1525,39.7685,13097,0,0.0,12804,0.9776284645338628,12804,0.9776284645338628,293,0.022371535466137283,71,0,0.0,40,0.5633802816901409,40,0.5633802816901409,31,0.43661971830985913
-86.1525,39.769,3424,0,0.0,1441,0.42085280373831774,1441,0.42085280373831774,1983,0.5791471962616822,65,0,0.0,16,0.24615384615384617,16,0.24615384615384617,49,0.7538461538461538
-86.1525,39.7695,5170,0,0.0,69,0.013346228239845262,69,0.013346228239845262,5101,0.9866537717601548,38,0,0.0,3,0.07894736842105263,3,0.07894736842105263,35,0.9210526315789473
-86.1525,39.77,3941,0,0.0,1626,0.41258563816290283,1626,0.41258563816290283,2315,0.5874143618370972,55,0,0.0,31,0.5636363636363636,31,0.5636363636363636,24,0.43636363636363634
-86.1525,39.7705,1497,0,0.0,1458,0.9739478957915831,1458,0.9739478957915831,39,0.026052104208416832,23,0,0.0,22,0.9565217391304348,22,0.9565217391304348,1,0.043478260869565216
-86.1525,39.771,3228,0,0.0,3190,0.9882280049566295,3190,0.9882280049566295,38,0.011771995043370507,46,0,0.0,41,0.8913043478260869,41,0.8913043478260869,5,0.10869565217391304
-86.1525,39.7715,608,0,0.0,504,0.8289473684210527,504,0.8289473684210527,104,0.17105263157894737,42,0,0.0,28,0.6666666666666666,28,0.6666666666666666,14,0.3333333333333333
-86.1525,39.772,340,0,0.0,331,0.9735294117647059,331,0.9735294117647059,9,0.026470588235294117,14,0,0.0,12,0.8571428571428571,12,0.8571428571428571,2,0.14285714285714285
-86.1525,39.7725,2032,0,0.0,1277,0.6284448818897638,1277,0.6284448818897638,755,0.3715551181102362,19,0,0.0,11,0.5789473684210527,11,0.5789473684210527,8,0.42105263157894735
-86.1525,39.773,267,0,0.0,32,0.1198501872659176,32,0.1198501872659176,235,0.8801498127340824,17,0,0.0,3,0.17647058823529413,3,0.17647058823529413,14,0.8235294117647058
-86.1525,39.7735,1231,0,0.0,738,0.5995125913891145,738,0.5995125913891145,493,0.40048740861088544,39,0,0.0,25,0.6410256410256411,25,0.6410256410256411,14,0.358974358974359
-86.1525,39.774,873,0,0.0,794,0.9095074455899198,794,0.9095074455899198,79,0.09049255441008018,26,0,0.0,17,0.6538461538461539,17,0.6538461538461539,9,0.34615384615384615
-86.1525,39.7745,111,0,0.0,25,0.22522522522522523,25,0.22522522522522523,86,0.7747747747747747,5,0,0.0,2,0.4,2,0.4,3,0.6
-86.1525,39.775,1614,0,0.0,404,0.2503097893432466,404,0.2503097893432466,1210,0.7496902106567535,31,0,0.0,11,0.3548387096774194,11,0.3548387096774194,20,0.6451612903225806
-86.1525,39.7755,29,0,0.0,29,1.0,29,1.0,0,0.0,3,0,0.0,3,1.0,3,1.0,0,0.0
-86.1525,39.7775,847,0,0.0,737,0.8701298701298701,737,0.8701298701298701,110,0.12987012987012986,21,0,0.0,13,0.6190476190476191,13,0.6190476190476191,8,0.38095238095238093
-86.1525,39.779,2,0,0.0,0,0.0,0,0.0,2,1.0,1,0,0.0,0,0.0,0,0.0,1,1.0
-86.152,39.761,361,0,0.0,32,0.0886426592797784,32,0.0886426592797784,329,0.9113573407202216,9,0,0.0,1,0.1111111111111111,1,0.1111111111111111,8,0.8888888888888888
-86.152,39.7625,79,0,0.0,79,1.0,79,1.0,0,0.0,1,0,0.0,1,1.0,1,1.0,0,0.0
-86.152,39.7635,43,0,0.0,43,1.0,43,1.0,0,0.0,1,0,0.0,1,1.0,1,1.0,0,0.0
-86.152,39.7655,1177,0,0.0,1165,0.989804587935429,1165,0.989804587935429,12,0.010195412064570943,28,0,0.0,25,0.8928571428571429,25,0.8928571428571429,3,0.10714285714285714
-86.152,39.766,153,0,0.0,153,1.0,153,1.0,0,0.0,17,0,0.0,17,1.0,17,1.0,0,0.0
-86.152,39.7665,2172,0,0.0,2160,0.994475138121547,2160,0.994475138121547,12,0.0055248618784530384,15,0,0.0,11,0.7333333333333333,11,0.7333333333333333,4,0.26666666666666666
-86.152,39.767,175,0,0.0,170,0.9714285714285714,170,0.9714285714285714,5,0.02857142857142857,6,0,0.0,4,0.6666666666666666,4,0.6666666666666666,2,0.3333333333333333
-86.152,39.768,9,0,0.0,9,1.0,9,1.0,0,0.0,1,0,0.0,1,1.0,1,1.0,0,0.0
-86.152,39.7685,23,0,0.0,23,1.0,23,1.0,0,0.0,1,0,0.0,1,1.0,1,1.0,0,0.0
-86.152,39.7695,3334,0,0.0,0,0.0,0,0.0,3334,1.0,12,0,0.0,0,0.0,0,0.0,12,1.0
-86.152,39.7705,73,0,0.0,73,1.0,73,1.0,0,0.0,2,0,0.0,2,1.0,2,1.0,0,0.0
-86.152,39.771,1055,0,0.0,1017,0.9639810426540284,1017,0.9639810426540284,38,0.03601895734597156,24,0,0.0,22,0.9166666666666666,22,0.9166666666666666,2,0.08333333333333333
-86.152,39.7715,524,0,0.0,460,0.8778625954198473,460,0.8778625954198473,64,0.12213740458015267,27,0,0.0,18,0.6666666666666666,18,0.6666666666666666,9,0.3333333333333333
-86.152,39.772,648,0,0.0,563,0.8688271604938271,563,0.8688271604938271,85,0.13117283950617284,24,0,0.0,15,0.625,15,0.625,9,0.375
-86.152,39.7725,3618,0,0.0,2756,0.761746821448314,2756,0.761746821448314,862,0.238253178551686,40,0,0.0,22,0.55,22,0.55,18,0.45
-86.152,39.773,755,0,0.0,361,0.4781456953642384,361,0.4781456953642384,394,0.5218543046357615,33,0,0.0,11,0.3333333333333333,11,0.3333333333333333,22,0.6666666666666666
-86.152,39.7735,1453,0,0.0,1009,0.6944253269098417,1009,0.6944253269098417,444,0.3055746730901583,39,0,0.0,24,0.6153846153846154,24,0.6153846153846154,15,0.38461538461538464
-86.152,39.774,3522,0,0.0,1912,0.5428733674048836,1912,0.5428733674048836,1610,0.45712663259511643,68,0,0.0,30,0.4411764705882353,30,0.4411764705882353,38,0.5588235294117647
-86.152,39.7745,1161,0,0.0,214,0.1843238587424634,214,0.1843238587424634,947,0.8156761412575366,32,0,0.0,12,0.375,12,0.375,20,0.625
-86.152,39.775,2582,0,0.0,747,0.2893106119287374,747,0.2893106119287374,1835,0.7106893880712626,39,0,0.0,11,0.28205128205128205,11,0.28205128205128205,28,0.717948717948718
-86.152,39.7755,5683,0,0.0,2235,0.393278198134788,2235,0.393278198134788,3448,0.6067218018652121,45,0,0.0,28,0.6222222222222222,28,0.6222222222222222,17,0.37777777777777777
-86.152,39.776,834,0,0.0,773,0.9268585131894485,773,0.9268585131894485,61,0.07314148681055156,50,0,0.0,36,0.72,36,0.72,14,0.28
-86.152,39.7765,764,0,0.0,751,0.9829842931937173,751,0.9829842931937173,13,0.017015706806282723,20,0,0.0,18,0.9,18,0.9,2,0.1
-86.152,39.777,962,0,0.0,962,1.0,962,1.0,0,0.0,15,0,0.0,15,1.0,15,1.0,0,0.0
-86.152,39.7775,4608,0,0.0,4515,0.9798177083333334,4515,0.9798177083333334,93,0.020182291666666668,33,0,0.0,24,0.7272727272727273,24,0.7272727272727273,9,0.2727272727272727
-86.152,39.778,206,0,0.0,206,1.0,206,1.0,0,0.0,2,0,0.0,2,1.0,2,1.0,0,0.0
-86.152,39.7785,805,0,0.0,770,0.9565217391304348,770,0.9565217391304348,35,0.043478260869565216,9,0,0.0,3,0.3333333333333333,3,0.3333333333333333,6,0.6666666666666666
-86.152,39.779,112,0,0.0,46,0.4107142857142857,46,0.4107142857142857,66,0.5892857142857143,5,0,0.0,3,0.6,3,0.6,2,0.4
-86.152,39.7795,111,0,0.0,47,0.42342342342342343,47,0.42342342342342343,64,0.5765765765765766,4,0,0.0,2,0.5,2,0.5,2,0.5
-86.152,39.78,256,0,0.0,196,0.765625,196,0.765625,60,0.234375,9,0,0.0,6,0.6666666666666666,6,0.6666666666666666,3,0.3333333333333333
-86.152,39.7805,122,0,0.0,122,1.0,122,1.0,0,0.0,3,0,0.0,3,1.0,3,1.0,0,0.0
-86.1515,39.761,344,0,0.0,28,0.08139534883720931,28,0.08139534883720931,316,0.9186046511627907,9,0,0.0,1,0.1111111111111111,1,0.1111111111111111,8,0.8888888888888888
-86.1515,39.7625,81,0,0.0,81,1.0,81,1.0,0,0.0,1,0,0.0,1,1.0,1,1.0,0,0.0
-86.1515,39.763,37,0,0.0,37,1.0,37,1.0,0,0.0,1,0,0.0,1,1.0,1,1.0,0,0.0
-86.1515,39.7635,7,0,0.0,7,1.0,7,1.0,0,0.0,1,0,0.0,1,1.0,1,1.0,0,0.0
-86.1515,39.7655,12,0,0.0,12,1.0,12,1.0,0,0.0,4,0,0.0,4,1.0,4,1.0,0,0.0
-86.1515,39.766,1147,0,0.0,1118,0.974716652136007,1118,0.974716652136007,29,0.025283347863993024,39,0,0.0,30,0.7692307692307693,30,0.7692307692307693,9,0.23076923076923078
-86.1515,39.7665,3749,0,0.0,3719,0.9919978660976261,3719,0.9919978660976261,30,0.008002133902373967,47,0,0.0,37,0.7872340425531915,37,0.7872340425531915,10,0.2127659574468085
-86.1515,39.767,108,0,0.0,100,0.9259259259259259,100,0.9259259259259259,8,0.07407407407407407,8,0,0.0,5,0.625,5,0.625,3,0.375
-86.1515,39.7695,647,0,0.0,13,0.02009273570324575,13,0.02009273570324575,634,0.9799072642967542,16,0,0.0,3,0.1875,3,0.1875,13,0.8125
-86.1515,39.771,9362,0,0.0,9349,0.9986114078188422,9349,0.9986114078188422,13,0.0013885921811578722,28,0,0.0,25,0.8928571428571429,25,0.8928571428571429,3,0.10714285714285714
-86.1515,39.7725,60,0,0.0,60,1.0,60,1.0,0,0.0,1,0,0.0,1,1.0,1,1.0,0,0.0
-86.1515,39.7735,1001,0,0.0,927,0.926073926073926,927,0.926073926073926,74,0.07392607392607392,47,0,0.0,32,0.6808510638297872,32,0.6808510638297872,15,0.3191489361702128
-86.1515,39.774,48,0,0.0,38,0.7916666666666666,38,0.7916666666666666,10,0.20833333333333334,6,0,0.0,4,0.6666666666666666,4,0.6666666666666666,2,0.3333333333333333
-86.1515,39.775,840,0,0.0,564,0.6714285714285714,564,0.6714285714285714,276,0.32857142857142857,19,0,0.0,9,0.47368421052631576,9,0.47368421052631576,10,0.5263157894736842
-86.1515,39.776,9,0,0.0,9,1.0,9,1.0,0,0.0,1,0,0.0,1,1.0,1,1.0,0,0.0
-86.1515,39.7765,14,0,0.0,14,1.0,14,1.0,0,0.0,1,0,0.0,1,1.0,1,1.0,0,0.0
-86.1515,39.7775,3450,0,0.0,2849,0.8257971014492753,2849,0.8257971014492753,601,0.17420289855072463,35,0,0.0,25,0.7142857142857143,25,0.7142857142857143,10,0.2857142857142857
-86.1515,39.7785,93,0,0.0,93,1.0,93,1.0,0,0.0,1,0,0.0,1,1.0,1,1.0,0,0.0
-86.1515,39.779,8,0,0.0,8,1.0,8,1.0,0,0.0,1,0,0.0,1,1.0,1,1.0,0,0.0
-86.151,39.761,481,0,0.0,96,0.1995841995841996,96,0.1995841995841996,385,0.8004158004158004,13,0,0.0,4,0.3076923076923077,4,0.3076923076923077,9,0.6923076923076923
-86.151,39.7615,115,0,0.0,115,1.0,115,1.0,0,0.0,1,0,0.0,1,1.0,1,1.0,0,0.0
-86.151,39.762,121,0,0.0,121,1.0,121,1.0,0,0.0,1,0,0.0,1,1.0,1,1.0,0,0.0
-86.151,39.7625,294,0,0.0,294,1.0,294,1.0,0,0.0,1,0,0.0,1,1.0,1,1.0,0,0.0
-86.151,39.763,18,0,0.0,18,1.0,18,1.0,0,0.0,1,0,0.0,1,1.0,1,1.0,0,0.0
-86.151,39.766,41,0,0.0,38,0.926829268292683,38,0.926829268292683,3,0.07317073170731707,6,0,0.0,5,0.8333333333333334,5,0.8333333333333334,1,0.16666666666666666
-86.151,39.7665,7309,0,0.0,7254,0.9924750307839649,7254,0.9924750307839649,55,0.007524969216035025,57,0,0.0,43,0.7543859649122807,43,0.7543859649122807,14,0.24561403508771928
-86.151,39.767,34,0,0.0,34,1.0,34,1.0,0,0.0,2,0,0.0,2,1.0,2,1.0,0,0.0
-86.151,39.7695,1744,0,0.0,1021,0.5854357798165137,1021,0.5854357798165137,723,0.41456422018348627,35,0,0.0,17,0.4857142857142857,17,0.4857142857142857,18,0.5142857142857142
-86.151,39.771,1800,0,0.0,1791,0.995,1791,0.995,9,0.005,24,0,0.0,22,0.9166666666666666,22,0.9166666666666666,2,0.08333333333333333
-86.151,39.7725,37,0,0.0,32,0.8648648648648649,32,0.8648648648648649,5,0.13513513513513514,3,0,0.0,2,0.6666666666666666,2,0.6666666666666666,1,0.3333333333333333
-86.151,39.7735,603,0,0.0,580,0.9618573797678275,580,0.9618573797678275,23,0.03814262023217247,18,0,0.0,16,0.8888888888888888,16,0.8888888888888888,2,0.1111111111111111
-86.151,39.774,56,0,0.0,56,1.0,56,1.0,0,0.0,2,0,0.0,2,1.0,2,1.0,0,0.0
-86.151,39.775,476,0,0.0,277,0.5819327731092437,277,0.5819327731092437,199,0.4180672268907563,25,0,0.0,12,0.48,12,0.48,13,0.52
-86.151,39.7765,18,0,0.0,18,1.0,18,1.0,0,0.0,1,0,0.0,1,1.0,1,1.0,0,0.0
-86.151,39.777,4,0,0.0,4,1.0,4,1.0,0,0.0,1,0,0.0,1,1.0,1,1.0,0,0.0
-86.151,39.7775,1007,0,0.0,965,0.958291956305859,965,0.958291956305859,42,0.041708043694141016,20,0,0.0,17,0.85,17,0.85,3,0.15
-86.151,39.779,54,0,0.0,54,1.0,54,1.0,0,0.0,1,0,0.0,1,1.0,1,1.0,0,0.0
-86.151,39.7795,8,0,0.0,8,1.0,8,1.0,0,0.0,1,0,0.0,1,1.0,1,1.0,0,0.0
-86.1505,39.761,591,0,0.0,267,0.4517766497461929,267,0.4517766497461929,324,0.5482233502538071,10,0,0.0,4,0.4,4,0.4,6,0.6
-86.1505,39.762,50,0,0.0,50,1.0,50,1.0,0,0.0,1,0,0.0,1,1.0,1,1.0,0,0.0
-86.1505,39.7625,43,0,0.0,43,1.0,43,1.0,0,0.0,1,0,0.0,1,1.0,1,1.0,0,0.0
-86.1505,39.7665,5905,0,0.0,5905,1.0,5905,1.0,0,0.0,30,0,0.0,30,1.0,30,1.0,0,0.0
-86.1505,39.767,1707,0,0.0,1706,0.9994141769185706,1706,0.9994141769185706,1,0.0005858230814294083,23,0,0.0,22,0.9565217391304348,22,0.9565217391304348,1,0.043478260869565216
-86.1505,39.7675,2190,0,0.0,312,0.14246575342465753,312,0.14246575342465753,1878,0.8575342465753425,48,0,0.0,25,0.5208333333333334,25,0.5208333333333334,23,0.4791666666666667
-86.1505,39.768,4705,0,0.0,109,0.02316684378320935,109,0.02316684378320935,4596,0.9768331562167907,22,0,0.0,2,0.09090909090909091,2,0.09090909090909091,20,0.9090909090909091
-86.1505,39.7685,2531,0,0.0,142,0.05610430659818254,142,0.05610430659818254,2389,0.9438956934018174,25,0,0.0,3,0.12,3,0.12,22,0.88
-86.1505,39.769,5991,0,0.0,3756,0.6269404106159239,3756,0.6269404106159239,2235,0.37305958938407613,95,0,0.0,41,0.43157894736842106,41,0.43157894736842106,54,0.5684210526315789
-86.1505,39.7695,4543,0,0.0,4496,0.9896544133832269,4496,0.9896544133832269,47,0.010345586616773057,67,0,0.0,53,0.7910447761194029,53,0.7910447761194029,14,0.208955223880597
-86.1505,39.77,1473,0,0.0,1473,1.0,1473,1.0,0,0.0,22,0,0.0,22,1.0,22,1.0,0,0.0
-86.1505,39.7705,1449,0,0.0,1449,1.0,1449,1.0,0,0.0,26,0,0.0,26,1.0,26,1.0,0,0.0
-86.1505,39.771,2845,0,0.0,2627,0.9233743409490334,2627,0.9233743409490334,218,0.0766256590509666,96,0,0.0,69,0.71875,69,0.71875,27,0.28125
-86.1505,39.7715,1171,0,0.0,1088,0.9291204099060631,1088,0.9291204099060631,83,0.07087959009393681,45,0,0.0,32,0.7111111111111111,32,0.7111111111111111,13,0.28888888888888886
-86.1505,39.772,2039,0,0.0,1652,0.8102010789602746,1652,0.8102010789602746,387,0.18979892103972534,81,0,0.0,51,0.6296296296296297,51,0.6296296296296297,30,0.37037037037037035
-86.1505,39.7725,1764,0,0.0,1631,0.9246031746031746,1631,0.9246031746031746,133,0.07539682539682539,68,0,0.0,44,0.6470588235294118,44,0.6470588235294118,24,0.35294117647058826
-86.1505,39.773,3245,0,0.0,3147,0.9697996918335902,3147,0.9697996918335902,98,0.03020030816640986,55,0,0.0,43,0.7818181818181819,43,0.7818181818181819,12,0.21818181818181817
-86.1505,39.7735,6223,0,0.0,6159,0.9897155712678772,6159,0.9897155712678772,64,0.01028442873212277,62,0,0.0,54,0.8709677419354839,54,0.8709677419354839,8,0.12903225806451613
-86.1505,39.774,1044,0,0.0,946,0.9061302681992337,946,0.9061302681992337,98,0.09386973180076628,33,0,0.0,24,0.7272727272727273,24,0.7272727272727273,9,0.2727272727272727
-86.1505,39.7745,1313,0,0.0,1036,0.789032749428789,1036,0.789032749428789,277,0.21096725057121096,33,0,0.0,27,0.8181818181818182,27,0.8181818181818182,6,0.18181818181818182
-86.1505,39.775,3122,0,0.0,2921,0.935618193465727,2921,0.935618193465727,201,0.0643818065342729,72,0,0.0,49,0.6805555555555556,49,0.6805555555555556,23,0.3194444444444444
-86.1505,39.7755,534,0,0.0,443,0.8295880149812734,443,0.8295880149812734,91,0.1704119850187266,44,0,0.0,25,0.5681818181818182,25,0.5681818181818182,19,0.4318181818181818
-86.1505,39.776,85,0,0.0,85,1.0,85,1.0,0,0.0,6,0,0.0,6,1.0,6,1.0,0,0.0
-86.1505,39.7765,27,0,0.0,27,1.0,27,1.0,0,0.0,1,0,0.0,1,1.0,1,1.0,0,0.0
-86.1505,39.777,82,0,0.0,82,1.0,82,1.0,0,0.0,3,0,0.0,3,1.0,3,1.0,0,0.0
-86.1505,39.7775,1139,0,0.0,1118,0.9815627743634767,1118,0.9815627743634767,21,0.018437225636523266,20,0,0.0,19,0.95,19,0.95,1,0.05
-86.1505,39.7795,50,0,0.0,50,1.0,50,1.0,0,0.0,1,0,0.0,1,1.0,1,1.0,0,0.0
-86.1505,39.78,11,0,0.0,11,1.0,11,1.0,0,0.0,1,0,0.0,1,1.0,1,1.0,0,0.0
-86.15,39.761,340,0,0.0,165,0.4852941176470588,165,0.4852941176470588,175,0.5147058823529411,8,0,0.0,4,0.5,4,0.5,4,0.5
-86.15,39.7615,15,0,0.0,15,1.0,15,1.0,0,0.0,1,0,0.0,1,1.0,1,1.0,0,0.0
-86.15,39.762,47,0,0.0,47,1.0,47,1.0,0,0.0,1,0,0.0,1,1.0,1,1.0,0,0.0
-86.15,39.7665,2152,0,0.0,2077,0.9651486988847584,2077,0.9651486988847584,75,0.03485130111524164,55,0,0.0,36,0.6545454545454545,36,0.6545454545454545,19,0.34545454545454546
-86.15,39.767,26,0,0.0,16,0.6153846153846154,16,0.6153846153846154,10,0.38461538461538464,4,0,0.0,2,0.5,2,0.5,2,0.5
-86.15,39.7695,854,0,0.0,845,0.9894613583138173,845,0.9894613583138173,9,0.01053864168618267,18,0,0.0,16,0.8888888888888888,16,0.8888888888888888,2,0.1111111111111111
-86.15,39.771,788,0,0.0,614,0.7791878172588832,614,0.7791878172588832,174,0.22081218274111675,44,0,0.0,23,0.5227272727272727,23,0.5227272727272727,21,0.4772727272727273
-86.15,39.7725,74,0,0.0,74,1.0,74,1.0,0,0.0,2,0,0.0,2,1.0,2,1.0,0,0.0
-86.15,39.7735,1995,0,0.0,1946,0.9754385964912281,1946,0.9754385964912281,49,0.02456140350877193,31,0,0.0,22,0.7096774193548387,22,0.7096774193548387,9,0.2903225806451613
-86.15,39.774,85,0,0.0,85,1.0,85,1.0,0,0.0,1,0,0.0,1,1.0,1,1.0,0,0.0
-86.15,39.7745,114,0,0.0,49,0.4298245614035088,49,0.4298245614035088,65,0.5701754385964912,4,0,0.0,3,0.75,3,0.75,1,0.25
-86.15,39.775,1247,0,0.0,1174,0.9414595028067362,1174,0.9414595028067362,73,0.05854049719326383,37,0,0.0,26,0.7027027027027027,26,0.7027027027027027,11,0.2972972972972973
-86.15,39.7755,442,0,0.0,339,0.7669683257918553,339,0.7669683257918553,103,0.2330316742081448,41,0,0.0,21,0.5121951219512195,21,0.5121951219512195,20,0.4878048780487805
-86.15,39.776,1404,0,0.0,1365,0.9722222222222222,1365,0.9722222222222222,39,0.027777777777777776,25,0,0.0,16,0.64,16,0.64,9,0.36
-86.15,39.7765,1588,0,0.0,1566,0.9861460957178841,1566,0.9861460957178841,22,0.013853904282115869,20,0,0.0,15,0.75,15,0.75,5,0.25
-86.15,39.777,1203,0,0.0,1203,1.0,1203,1.0,0,0.0,12,0,0.0,12,1.0,12,1.0,0,0.0
-86.15,39.7775,2598,0,0.0,2572,0.9899923017705927,2572,0.9899923017705927,26,0.010007698229407237,27,0,0.0,23,0.8518518518518519,23,0.8518518518518519,4,0.14814814814814814
-86.15,39.78,50,0,0.0,50,1.0,50,1.0,0,0.0,1,0,0.0,1,1.0,1,1.0,0,0.0
-86.15,39.7805,13,0,0.0,13,1.0,13,1.0,0,0.0,1,0,0.0,1,1.0,1,1.0,0,0.0
-86.1495,39.761,2169,0,0.0,1735,0.7999077916090365,1735,0.7999077916090365,434,0.2000922083909636,16,0,0.0,8,0.5,8,0.5,8,0.5
-86.1495,39.7615,72,0,0.0,72,1.0,72,1.0,0,0.0,1,0,0.0,1,1.0,1,1.0,0,0.0
-86.1495,39.7665,2141,0,0.0,2124,0.9920597851471276,2124,0.9920597851471276,17,0.007940214852872489,24,0,0.0,20,0.8333333333333334,20,0.8333333333333334,4,0.16666666666666666
-86.1495,39.767,4,0,0.0,4,1.0,4,1.0,0,0.0,1,0,0.0,1,1.0,1,1.0,0,0.0
-86.1495,39.7695,548,0,0.0,538,0.9817518248175182,538,0.9817518248175182,10,0.01824817518248175,15,0,0.0,13,0.8666666666666667,13,0.8666666666666667,2,0.13333333333333333
-86.1495,39.771,782,0,0.0,120,0.1534526854219949,120,0.1534526854219949,662,0.8465473145780051,38,0,0.0,10,0.2631578947368421,10,0.2631578947368421,28,0.7368421052631579
-86.1495,39.7725,52,0,0.0,49,0.9423076923076923,49,0.9423076923076923,3,0.057692307692307696,3,0,0.0,2,0.6666666666666666,2,0.6666666666666666,1,0.3333333333333333
-86.1495,39.7735,802,0,0.0,696,0.8678304239401496,696,0.8678304239401496,106,0.13216957605985039,36,0,0.0,24,0.6666666666666666,24,0.6666666666666666,12,0.3333333333333333
-86.1495,39.774,66,0,0.0,60,0.9090909090909091,60,0.9090909090909091,6,0.09090909090909091,4,0,0.0,3,0.75,3,0.75,1,0.25
-86.1495,39.775,299,0,0.0,295,0.9866220735785953,295,0.9866220735785953,4,0.013377926421404682,11,0,0.0,10,0.9090909090909091,10,0.9090909090909091,1,0.09090909090909091
-86.1495,39.7775,695,0,0.0,695,1.0,695,1.0,0,0.0,7,0,0.0,7,1.0,7,1.0,0,0.0
-86.1495,39.7805,59,0,0.0,59,1.0,59,1.0,0,0.0,1,0,0.0,1,1.0,1,1.0,0,0.0
-86.149,39.761,659,0,0.0,607,0.921092564491654,607,0.921092564491654,52,0.07890743550834597,10,0,0.0,9,0.9,9,0.9,1,0.1
-86.149,39.7615,1866,0,0.0,1866,1.0,1866,1.0,0,0.0,7,0,0.0,7,1.0,7,1.0,0,0.0
-86.149,39.762,582,0,0.0,582,1.0,582,1.0,0,0.0,7,0,0.0,7,1.0,7,1.0,0,0.0
-86.149,39.7625,410,0,0.0,410,1.0,410,1.0,0,0.0,7,0,0.0,7,1.0,7,1.0,0,0.0
-86.149,39.763,393,0,0.0,393,1.0,393,1.0,0,0.0,7,0,0.0,7,1.0,7,1.0,0,0.0
-86.149,39.7635,407,0,0.0,407,1.0,407,1.0,0,0.0,7,0,0.0,7,1.0,7,1.0,0,0.0
-86.149,39.764,1641,0,0.0,1641,1.0,1641,1.0,0,0.0,7,0,0.0,7,1.0,7,1.0,0,0.0
-86.149,39.7645,405,0,0.0,369,0.9111111111111111,369,0.9111111111111111,36,0.08888888888888889,25,0,0.0,17,0.68,17,0.68,8,0.32
-86.149,39.765,400,0,0.0,388,0.97,388,0.97,12,0.03,14,0,0.0,12,0.8571428571428571,12,0.8571428571428571,2,0.14285714285714285
-86.149,39.7655,411,0,0.0,411,1.0,411,1.0,0,0.0,14,0,0.0,14,1.0,14,1.0,0,0.0
-86.149,39.766,703,0,0.0,703,1.0,703,1.0,0,0.0,11,0,0.0,11,1.0,11,1.0,0,0.0
-86.149,39.7665,3120,0,0.0,3120,1.0,3120,1.0,0,0.0,27,0,0.0,27,1.0,27,1.0,0,0.0
-86.149,39.767,2552,0,0.0,2552,1.0,2552,1.0,0,0.0,19,0,0.0,19,1.0,19,1.0,0,0.0
-86.149,39.7675,1022,0,0.0,1010,0.9882583170254403,1010,0.9882583170254403,12,0.011741682974559686,21,0,0.0,18,0.8571428571428571,18,0.8571428571428571,3,0.14285714285714285
-86.149,39.768,750,0,0.0,589,0.7853333333333333,589,0.7853333333333333,161,0.21466666666666667,33,0,0.0,24,0.7272727272727273,24,0.7272727272727273,9,0.2727272727272727
-86.149,39.7685,2197,0,0.0,2103,0.9572143832498862,2103,0.9572143832498862,94,0.04278561675011379,51,0,0.0,31,0.6078431372549019,31,0.6078431372549019,20,0.39215686274509803
-86.149,39.769,118,0,0.0,103,0.8728813559322034,103,0.8728813559322034,15,0.1271186440677966,10,0,0.0,7,0.7,7,0.7,3,0.3
-86.149,39.7695,1895,0,0.0,1855,0.978891820580475,1855,0.978891820580475,40,0.021108179419525065,27,0,0.0,20,0.7407407407407407,20,0.7407407407407407,7,0.25925925925925924
-86.149,39.771,2172,0,0.0,1788,0.8232044198895028,1788,0.8232044198895028,384,0.17679558011049723,53,0,0.0,19,0.3584905660377358,19,0.3584905660377358,34,0.6415094339622641
-86.149,39.772,19,0,0.0,19,1.0,19,1.0,0,0.0,1,0,0.0,1,1.0,1,1.0,0,0.0
-86.149,39.7725,38,0,0.0,38,1.0,38,1.0,0,0.0,1,0,0.0,1,1.0,1,1.0,0,0.0
-86.149,39.7735,816,0,0.0,814,0.9975490196078431,814,0.9975490196078431,2,0.0024509803921568627,23,0,0.0,22,0.9565217391304348,22,0.9565217391304348,1,0.043478260869565216
-86.149,39.774,80,0,0.0,80,1.0,80,1.0,0,0.0,1,0,0.0,1,1.0,1,1.0,0,0.0
-86.149,39.7745,5,0,0.0,5,1.0,5,1.0,0,0.0,1,0,0.0,1,1.0,1,1.0,0,0.0
-86.149,39.775,2656,0,0.0,2649,0.9973644578313253,2649,0.9973644578313253,7,0.0026355421686746986,15,0,0.0,13,0.8666666666666667,13,0.8666666666666667,2,0.13333333333333333
-86.149,39.7775,825,0,0.0,825,1.0,825,1.0,0,0.0,7,0,0.0,7,1.0,7,1.0,0,0.0
-86.149,39.7805,52,0,0.0,52,1.0,52,1.0,0,0.0,1,0,0.0,1,1.0,1,1.0,0,0.0
-86.1485,39.7665,78,0,0.0,78,1.0,78,1.0,0,0.0,4,0,0.0,4,1.0,4,1.0,0,0.0
-86.1485,39.767,348,0,0.0,348,1.0,348,1.0,0,0.0,1,0,0.0,1,1.0,1,1.0,0,0.0
-86.1485,39.7675,159,0,0.0,159,1.0,159,1.0,0,0.0,4,0,0.0,4,1.0,4,1.0,0,0.0
-86.1485,39.768,1252,0,0.0,1132,0.9041533546325878,1132,0.9041533546325878,120,0.09584664536741214,26,0,0.0,18,0.6923076923076923,18,0.6923076923076923,8,0.3076923076923077
-86.1485,39.7685,2064,0,0.0,1938,0.938953488372093,1938,0.938953488372093,126,0.061046511627906974,67,0,0.0,39,0.582089552238806,39,0.582089552238806,28,0.417910447761194
-86.1485,39.769,1993,0,0.0,1872,0.9392875062719518,1872,0.9392875062719518,121,0.06071249372804817,66,0,0.0,44,0.6666666666666666,44,0.6666666666666666,22,0.3333333333333333
-86.1485,39.7695,3213,0,0.0,3129,0.9738562091503268,3129,0.9738562091503268,84,0.026143790849673203,58,0,0.0,39,0.6724137931034483,39,0.6724137931034483,19,0.3275862068965517
-86.1485,39.77,3389,0,0.0,3324,0.9808203009737385,3324,0.9808203009737385,65,0.019179699026261435,38,0,0.0,24,0.631578947368421,24,0.631578947368421,14,0.3684210526315789
-86.1485,39.7705,2376,0,0.0,2376,1.0,2376,1.0,0,0.0,11,0,0.0,11,1.0,11,1.0,0,0.0
-86.1485,39.771,1911,0,0.0,1896,0.9921507064364207,1896,0.9921507064364207,15,0.007849293563579277,31,0,0.0,25,0.8064516129032258,25,0.8064516129032258,6,0.1935483870967742
-86.1485,39.7715,509,0,0.0,509,1.0,509,1.0,0,0.0,6,0,0.0,6,1.0,6,1.0,0,0.0
-86.1485,39.772,424,0,0.0,424,1.0,424,1.0,0,0.0,9,0,0.0,9,1.0,9,1.0,0,0.0
-86.1485,39.7725,900,0,0.0,876,0.9733333333333334,876,0.9733333333333334,24,0.02666666666666667,14,0,0.0,12,0.8571428571428571,12,0.8571428571428571,2,0.14285714285714285
-86.1485,39.773,511,0,0.0,484,0.9471624266144814,484,0.9471624266144814,27,0.05283757338551859,21,0,0.0,15,0.7142857142857143,15,0.7142857142857143,6,0.2857142857142857
-86.1485,39.7735,3457,0,0.0,3359,0.9716517211455019,3359,0.9716517211455019,98,0.02834827885449812,52,0,0.0,41,0.7884615384615384,41,0.7884615384615384,11,0.21153846153846154
-86.1485,39.774,1145,0,0.0,1145,1.0,1145,1.0,0,0.0,7,0,0.0,7,1.0,7,1.0,0,0.0
-86.1485,39.7745,534,0,0.0,534,1.0,534,1.0,0,0.0,9,0,0.0,9,1.0,9,1.0,0,0.0
-86.1485,39.775,1310,0,0.0,1241,0.9473282442748091,1241,0.9473282442748091,69,0.05267175572519084,27,0,0.0,21,0.7777777777777778,21,0.7777777777777778,6,0.2222222222222222
-86.1485,39.7755,1845,0,0.0,1815,0.983739837398374,1815,0.983739837398374,30,0.016260162601626018,24,0,0.0,17,0.7083333333333334,17,0.7083333333333334,7,0.2916666666666667
-86.1485,39.776,249,0,0.0,237,0.9518072289156626,237,0.9518072289156626,12,0.04819277108433735,11,0,0.0,8,0.7272727272727273,8,0.7272727272727273,3,0.2727272727272727
-86.1485,39.7765,482,0,0.0,476,0.9875518672199171,476,0.9875518672199171,6,0.012448132780082987,9,0,0.0,8,0.8888888888888888,8,0.8888888888888888,1,0.1111111111111111
-86.1485,39.777,636,0,0.0,627,0.9858490566037735,627,0.9858490566037735,9,0.014150943396226415,11,0,0.0,9,0.8181818181818182,9,0.8181818181818182,2,0.18181818181818182
-86.1485,39.7775,2175,0,0.0,2151,0.9889655172413793,2151,0.9889655172413793,24,0.011034482758620689,22,0,0.0,16,0.7272727272727273,16,0.7272727272727273,6,0.2727272727272727
-86.1485,39.778,107,0,0.0,107,1.0,107,1.0,0,0.0,2,0,0.0,2,1.0,2,1.0,0,0.0
-86.1485,39.7785,85,0,0.0,85,1.0,85,1.0,0,0.0,2,0,0.0,2,1.0,2,1.0,0,0.0
-86.1485,39.779,79,0,0.0,77,0.9746835443037974,77,0.9746835443037974,2,0.02531645569620253,3,0,0.0,2,0.6666666666666666,2,0.6666666666666666,1,0.3333333333333333
-86.1485,39.7795,84,0,0.0,66,0.7857142857142857,66,0.7857142857142857,18,0.21428571428571427,5,0,0.0,3,0.6,3,0.6,2,0.4
-86.1485,39.78,101,0,0.0,101,1.0,101,1.0,0,0.0,2,0,0.0,2,1.0,2,1.0,0,0.0
-86.1485,39.7805,243,0,0.0,243,1.0,243,1.0,0,0.0,3,0,0.0,3,1.0,3,1.0,0,0.0
-86.148,39.7665,36,0,0.0,36,1.0,36,1.0,0,0.0,1,0,0.0,1,1.0,1,1.0,0,0.0
-86.148,39.768,44,0,0.0,15,0.3409090909090909,15,0.3409090909090909,29,0.6590909090909091,3,0,0.0,1,0.3333333333333333,1,0.3333333333333333,2,0.6666666666666666
-86.148,39.7695,110,0,0.0,109,0.990909090909091,109,0.990909090909091,1,0.00909090909090909,4,0,0.0,3,0.75,3,0.75,1,0.25
-86.148,39.771,548,0,0.0,546,0.9963503649635036,546,0.9963503649635036,2,0.0036496350364963502,20,0,0.0,18,0.9,18,0.9,2,0.1
-86.148,39.7725,43,0,0.0,43,1.0,43,1.0,0,0.0,1,0,0.0,1,1.0,1,1.0,0,0.0
-86.148,39.7735,2024,0,0.0,2020,0.9980237154150198,2020,0.9980237154150198,4,0.001976284584980237,15,0,0.0,14,0.9333333333333333,14,0.9333333333333333,1,0.06666666666666667
-86.148,39.775,161,0,0.0,116,0.7204968944099379,116,0.7204968944099379,45,0.2795031055900621,3,0,0.0,2,0.6666666666666666,2,0.6666666666666666,1,0.3333333333333333
-86.148,39.7755,608,0,0.0,608,1.0,608,1.0,0,0.0,4,0,0.0,4,1.0,4,1.0,0,0.0
-86.148,39.7765,53,0,0.0,53,1.0,53,1.0,0,0.0,1,0,0.0,1,1.0,1,1.0,0,0.0
-86.148,39.7775,1172,0,0.0,1167,0.9957337883959044,1167,0.9957337883959044,5,0.004266211604095563,6,0,0.0,5,0.8333333333333334,5,0.8333333333333334,1,0.16666666666666666
-86.148,39.7805,127,0,0.0,123,0.968503937007874,123,0.968503937007874,4,0.031496062992125984,5,0,0.0,4,0.8,4,0.8,1,0.2
-86.1475,39.7665,42,0,0.0,42,1.0,42,1.0,0,0.0,2,0,0.0,2,1.0,2,1.0,0,0.0
-86.1475,39.768,52,0,0.0,44,0.8461538461538461,44,0.8461538461538461,8,0.15384615384615385,3,0,0.0,2,0.6666666666666666,2,0.6666666666666666,1,0.3333333333333333
-86.1475,39.7695,98,0,0.0,98,1.0,98,1.0,0,0.0,3,0,0.0,3,1.0,3,1.0,0,0.0
-86.1475,39.771,534,0,0.0,480,0.898876404494382,480,0.898876404494382,54,0.10112359550561797,28,0,0.0,19,0.6785714285714286,19,0.6785714285714286,9,0.32142857142857145
-86.1475,39.7725,50,0,0.0,50,1.0,50,1.0,0,0.0,1,0,0.0,1,1.0,1,1.0,0,0.0
-86.1475,39.7735,579,0,0.0,575,0.9930915371329879,575,0.9930915371329879,4,0.0069084628670120895,12,0,0.0,10,0.8333333333333334,10,0.8333333333333334,2,0.16666666666666666
-86.1475,39.775,143,0,0.0,100,0.6993006993006993,100,0.6993006993006993,43,0.3006993006993007,4,0,0.0,3,0.75,3,0.75,1,0.25
-86.1475,39.7755,198,0,0.0,186,0.9393939393939394,186,0.9393939393939394,12,0.06060606060606061,9,0,0.0,7,0.7777777777777778,7,0.7777777777777778,2,0.2222222222222222
-86.1475,39.776,95,0,0.0,95,1.0,95,1.0,0,0.0,3,0,0.0,3,1.0,3,1.0,0,0.0
-86.1475,39.7765,58,0,0.0,58,1.0,58,1.0,0,0.0,1,0,0.0,1,1.0,1,1.0,0,0.0
-86.1475,39.7775,262,0,0.0,250,0.9541984732824428,250,0.9541984732824428,12,0.04580152671755725,8,0,0.0,6,0.75,6,0.75,2,0.25
-86.1475,39.7805,122,0,0.0,122,1.0,122,1.0,0,0.0,3,0,0.0,3,1.0,3,1.0,0,0.0
-86.147,39.7665,50,0,0.0,50,1.0,50,1.0,0,0.0,1,0,0.0,1,1.0,1,1.0,0,0.0
-86.147,39.767,68,0,0.0,64,0.9411764705882353,64,0.9411764705882353,4,0.058823529411764705,3,0,0.0,2,0.6666666666666666,2,0.6666666666666666,1,0.3333333333333333
-86.147,39.7675,95,0,0.0,91,0.9578947368421052,91,0.9578947368421052,4,0.042105263157894736,3,0,0.0,2,0.6666666666666666,2,0.6666666666666666,1,0.3333333333333333
-86.147,39.768,481,0,0.0,481,1.0,481,1.0,0,0.0,4,0,0.0,4,1.0,4,1.0,0,0.0
-86.147,39.7685,357,0,0.0,350,0.9803921568627451,350,0.9803921568627451,7,0.0196078431372549,5,0,0.0,4,0.8,4,0.8,1,0.2
-86.147,39.769,81,0,0.0,81,1.0,81,1.0,0,0.0,1,0,0.0,1,1.0,1,1.0,0,0.0
-86.147,39.7695,166,0,0.0,166,1.0,166,1.0,0,0.0,3,0,0.0,3,1.0,3,1.0,0,0.0
-86.147,39.771,671,0,0.0,558,0.8315946348733234,558,0.8315946348733234,113,0.16840536512667661,50,0,0.0,30,0.6,30,0.6,20,0.4
-86.147,39.7715,105,0,0.0,104,0.9904761904761905,104,0.9904761904761905,1,0.009523809523809525,4,0,0.0,3,0.75,3,0.75,1,0.25
-86.147,39.772,115,0,0.0,115,1.0,115,1.0,0,0.0,2,0,0.0,2,1.0,2,1.0,0,0.0
-86.147,39.7725,273,0,0.0,264,0.967032967032967,264,0.967032967032967,9,0.03296703296703297,6,0,0.0,4,0.6666666666666666,4,0.6666666666666666,2,0.3333333333333333
-86.147,39.773,124,0,0.0,106,0.8548387096774194,106,0.8548387096774194,18,0.14516129032258066,8,0,0.0,5,0.625,5,0.625,3,0.375
-86.147,39.7735,1187,0,0.0,1145,0.9646166807076664,1145,0.9646166807076664,42,0.03538331929233361,26,0,0.0,18,0.6923076923076923,18,0.6923076923076923,8,0.3076923076923077
-86.147,39.774,59,0,0.0,59,1.0,59,1.0,0,0.0,1,0,0.0,1,1.0,1,1.0,0,0.0
-86.147,39.7745,52,0,0.0,52,1.0,52,1.0,0,0.0,1,0,0.0,1,1.0,1,1.0,0,0.0
-86.147,39.775,436,0,0.0,432,0.9908256880733946,432,0.9908256880733946,4,0.009174311926605505,6,0,0.0,4,0.6666666666666666,4,0.6666666666666666,2,0.3333333333333333
-86.147,39.776,559,0,0.0,549,0.9821109123434705,549,0.9821109123434705,10,0.017889087656529516,11,0,0.0,8,0.7272727272727273,8,0.7272727272727273,3,0.2727272727272727
-86.147,39.7765,344,0,0.0,344,1.0,344,1.0,0,0.0,2,0,0.0,2,1.0,2,1.0,0,0.0
-86.147,39.777,77,0,0.0,77,1.0,77,1.0,0,0.0,1,0,0.0,1,1.0,1,1.0,0,0.0
-86.147,39.7775,324,0,0.0,324,1.0,324,1.0,0,0.0,5,0,0.0,5,1.0,5,1.0,0,0.0
-86.147,39.7805,125,0,0.0,125,1.0,125,1.0,0,0.0,3,0,0.0,3,1.0,3,1.0,0,0.0
-86.1465,39.768,297,0,0.0,293,0.9865319865319865,293,0.9865319865319865,4,0.013468013468013467,4,0,0.0,3,0.75,3,0.75,1,0.25
-86.1465,39.7695,67,0,0.0,67,1.0,67,1.0,0,0.0,2,0,0.0,2,1.0,2,1.0,0,0.0
-86.1465,39.771,528,0,0.0,507,0.9602272727272727,507,0.9602272727272727,21,0.03977272727272727,23,0,0.0,17,0.7391304347826086,17,0.7391304347826086,6,0.2608695652173913
-86.1465,39.7725,57,0,0.0,52,0.9122807017543859,52,0.9122807017543859,5,0.08771929824561403,2,0,0.0,1,0.5,1,0.5,1,0.5
-86.1465,39.7735,421,0,0.0,390,0.9263657957244655,390,0.9263657957244655,31,0.07363420427553444,22,0,0.0,16,0.7272727272727273,16,0.7272727272727273,6,0.2727272727272727
-86.1465,39.775,193,0,0.0,188,0.9740932642487047,188,0.9740932642487047,5,0.025906735751295335,5,0,0.0,4,0.8,4,0.8,1,0.2
-86.1465,39.7755,67,0,0.0,67,1.0,67,1.0,0,0.0,1,0,0.0,1,1.0,1,1.0,0,0.0
-86.1465,39.776,120,0,0.0,117,0.975,117,0.975,3,0.025,5,0,0.0,4,0.8,4,0.8,1,0.2
-86.1465,39.7765,300,0,0.0,289,0.9633333333333334,289,0.9633333333333334,11,0.03666666666666667,9,0,0.0,6,0.6666666666666666,6,0.6666666666666666,3,0.3333333333333333
-86.1465,39.7775,332,0,0.0,318,0.9578313253012049,318,0.9578313253012049,14,0.04216867469879518,13,0,0.0,9,0.6923076923076923,9,0.6923076923076923,4,0.3076923076923077
-86.1465,39.7805,130,0,0.0,130,1.0,130,1.0,0,0.0,3,0,0.0,3,1.0,3,1.0,0,0.0
-86.146,39.768,52,0,0.0,52,1.0,52,1.0,0,0.0,1,0,0.0,1,1.0,1,1.0,0,0.0
-86.146,39.7695,71,0,0.0,71,1.0,71,1.0,0,0.0,2,0,0.0,2,1.0,2,1.0,0,0.0
-86.146,39.7705,21,0,0.0,20,0.9523809523809523,20,0.9523809523809523,1,0.047619047619047616,2,0,0.0,1,0.5,1,0.5,1,0.5
-86.146,39.771,532,0,0.0,502,0.943609022556391,502,0.943609022556391,30,0.05639097744360902,22,0,0.0,15,0.6818181818181818,15,0.6818181818181818,7,0.3181818181818182
-86.146,39.7725,46,0,0.0,46,1.0,46,1.0,0,0.0,1,0,0.0,1,1.0,1,1.0,0,0.0
-86.146,39.7735,427,0,0.0,397,0.9297423887587822,397,0.9297423887587822,30,0.0702576112412178,27,0,0.0,20,0.7407407407407407,20,0.7407407407407407,7,0.25925925925925924
-86.146,39.775,143,0,0.0,143,1.0,143,1.0,0,0.0,2,0,0.0,2,1.0,2,1.0,0,0.0
-86.146,39.7765,139,0,0.0,139,1.0,139,1.0,0,0.0,3,0,0.0,3,1.0,3,1.0,0,0.0
-86.146,39.777,77,0,0.0,77,1.0,77,1.0,0,0.0,3,0,0.0,3,1.0,3,1.0,0,0.0
-86.146,39.7775,445,0,0.0,442,0.9932584269662922,442,0.9932584269662922,3,0.006741573033707865,8,0,0.0,7,0.875,7,0.875,1,0.125
-86.146,39.778,138,0,0.0,138,1.0,138,1.0,0,0.0,1,0,0.0,1,1.0,1,1.0,0,0.0
-86.146,39.7785,52,0,0.0,52,1.0,52,1.0,0,0.0,1,0,0.0,1,1.0,1,1.0,0,0.0
-86.146,39.779,57,0,0.0,57,1.0,57,1.0,0,0.0,1,0,0.0,1,1.0,1,1.0,0,0.0
-86.146,39.7795,106,0,0.0,106,1.0,106,1.0,0,0.0,1,0,0.0,1,1.0,1,1.0,0,0.0
-86.146,39.78,67,0,0.0,67,1.0,67,1.0,0,0.0,1,0,0.0,1,1.0,1,1.0,0,0.0
-86.146,39.7805,223,0,0.0,223,1.0,223,1.0,0,0.0,5,0,0.0,5,1.0,5,1.0,0,0.0
-86.1455,39.761,250,0,0.0,250,1.0,250,1.0,0,0.0,1,0,0.0,1,1.0,1,1.0,0,0.0
-86.1455,39.7615,81,0,0.0,81,1.0,81,1.0,0,0.0,1,0,0.0,1,1.0,1,1.0,0,0.0
-86.1455,39.762,81,0,0.0,81,1.0,81,1.0,0,0.0,1,0,0.0,1,1.0,1,1.0,0,0.0
-86.1455,39.7625,76,0,0.0,76,1.0,76,1.0,0,0.0,1,0,0.0,1,1.0,1,1.0,0,0.0
-86.1455,39.763,75,0,0.0,75,1.0,75,1.0,0,0.0,1,0,0.0,1,1.0,1,1.0,0,0.0
-86.1455,39.7635,84,0,0.0,84,1.0,84,1.0,0,0.0,1,0,0.0,1,1.0,1,1.0,0,0.0
-86.1455,39.764,83,0,0.0,83,1.0,83,1.0,0,0.0,1,0,0.0,1,1.0,1,1.0,0,0.0
-86.1455,39.7645,60,0,0.0,60,1.0,60,1.0,0,0.0,1,0,0.0,1,1.0,1,1.0,0,0.0
-86.1455,39.765,39,0,0.0,33,0.8461538461538461,33,0.8461538461538461,6,0.15384615384615385,3,0,0.0,2,0.6666666666666666,2,0.6666666666666666,1,0.3333333333333333
-86.1455,39.7655,40,0,0.0,40,1.0,40,1.0,0,0.0,1,0,0.0,1,1.0,1,1.0,0,0.0
-86.1455,39.766,51,0,0.0,51,1.0,51,1.0,0,0.0,2,0,0.0,2,1.0,2,1.0,0,0.0
-86.1455,39.7665,532,0,0.0,532,1.0,532,1.0,0,0.0,1,0,0.0,1,1.0,1,1.0,0,0.0
-86.1455,39.767,59,0,0.0,59,1.0,59,1.0,0,0.0,2,0,0.0,2,1.0,2,1.0,0,0.0
-86.1455,39.7675,42,0,0.0,42,1.0,42,1.0,0,0.0,1,0,0.0,1,1.0,1,1.0,0,0.0
-86.1455,39.768,630,0,0.0,609,0.9666666666666667,609,0.9666666666666667,21,0.03333333333333333,12,0,0.0,7,0.5833333333333334,7,0.5833333333333334,5,0.4166666666666667
-86.1455,39.7685,387,0,0.0,375,0.9689922480620154,375,0.9689922480620154,12,0.031007751937984496,6,0,0.0,4,0.6666666666666666,4,0.6666666666666666,2,0.3333333333333333
-86.1455,39.769,1965,0,0.0,1934,0.9842239185750636,1934,0.9842239185750636,31,0.015776081424936386,14,0,0.0,8,0.5714285714285714,8,0.5714285714285714,6,0.42857142857142855
-86.1455,39.7695,352,0,0.0,338,0.9602272727272727,338,0.9602272727272727,14,0.03977272727272727,10,0,0.0,7,0.7,7,0.7,3,0.3
-86.1455,39.77,170,0,0.0,170,1.0,170,1.0,0,0.0,2,0,0.0,2,1.0,2,1.0,0,0.0
-86.1455,39.7705,78,0,0.0,71,0.9102564102564102,71,0.9102564102564102,7,0.08974358974358974,3,0,0.0,2,0.6666666666666666,2,0.6666666666666666,1,0.3333333333333333
-86.1455,39.771,1359,0,0.0,1319,0.9705665930831494,1319,0.9705665930831494,40,0.029433406916850625,32,0,0.0,22,0.6875,22,0.6875,10,0.3125
-86.1455,39.7715,70,0,0.0,70,1.0,70,1.0,0,0.0,3,0,0.0,3,1.0,3,1.0,0,0.0
-86.1455,39.772,24,0,0.0,24,1.0,24,1.0,0,0.0,1,0,0.0,1,1.0,1,1.0,0,0.0
-86.1455,39.7725,53,0,0.0,53,1.0,53,1.0,0,0.0,1,0,0.0,1,1.0,1,1.0,0,0.0
-86.1455,39.7735,589,0,0.0,580,0.9847198641765704,580,0.9847198641765704,9,0.015280135823429542,14,0,0.0,12,0.8571428571428571,12,0.8571428571428571,2,0.14285714285714285
-86.1455,39.775,198,0,0.0,198,1.0,198,1.0,0,0.0,2,0,0.0,2,1.0,2,1.0,0,0.0
-86.1455,39.777,826,0,0.0,815,0.986682808716707,815,0.986682808716707,11,0.013317191283292978,9,0,0.0,6,0.6666666666666666,6,0.6666666666666666,3,0.3333333333333333
-86.1455,39.7775,635,0,0.0,627,0.9874015748031496,627,0.9874015748031496,8,0.012598425196850394,10,0,0.0,8,0.8,8,0.8,2,0.2
-86.1455,39.7805,160,0,0.0,160,1.0,160,1.0,0,0.0,5,0,0.0,5,1.0,5,1.0,0,0.0
-86.145,39.7695,439,0,0.0,427,0.9726651480637813,427,0.9726651480637813,12,0.02733485193621868,6,0,0.0,4,0.6666666666666666,4,0.6666666666666666,2,0.3333333333333333
-86.145,39.77,30,0,0.0,30,1.0,30,1.0,0,0.0,2,0,0.0,2,1.0,2,1.0,0,0.0
-86.145,39.7705,271,0,0.0,271,1.0,271,1.0,0,0.0,2,0,0.0,2,1.0,2,1.0,0,0.0
-86.145,39.771,675,0,0.0,675,1.0,675,1.0,0,0.0,5,0,0.0,5,1.0,5,1.0,0,0.0
-86.145,39.7715,866,0,0.0,862,0.9953810623556582,862,0.9953810623556582,4,0.004618937644341801,9,0,0.0,8,0.8888888888888888,8,0.8888888888888888,1,0.1111111111111111
-86.145,39.772,1938,0,0.0,1880,0.9700722394220846,1880,0.9700722394220846,58,0.029927760577915376,37,0,0.0,24,0.6486486486486487,24,0.6486486486486487,13,0.35135135135135137
-86.145,39.7725,762,0,0.0,745,0.9776902887139107,745,0.9776902887139107,17,0.02230971128608924,20,0,0.0,14,0.7,14,0.7,6,0.3
-86.145,39.773,2623,0,0.0,2506,0.9553945863515059,2506,0.9553945863515059,117,0.04460541364849409,12,0,0.0,10,0.8333333333333334,10,0.8333333333333334,2,0.16666666666666666
-86.145,39.7735,2953,0,0.0,2909,0.9850998984083983,2909,0.9850998984083983,44,0.014900101591601761,31,0,0.0,22,0.7096774193548387,22,0.7096774193548387,9,0.2903225806451613
-86.145,39.774,167,0,0.0,159,0.9520958083832335,159,0.9520958083832335,8,0.04790419161676647,7,0,0.0,5,0.7142857142857143,5,0.7142857142857143,2,0.2857142857142857
-86.145,39.7745,153,0,0.0,124,0.8104575163398693,124,0.8104575163398693,29,0.1895424836601307,12,0,0.0,7,0.5833333333333334,7,0.5833333333333334,5,0.4166666666666667
-86.145,39.775,1104,0,0.0,1072,0.9710144927536232,1072,0.9710144927536232,32,0.028985507246376812,19,0,0.0,13,0.6842105263157895,13,0.6842105263157895,6,0.3157894736842105
-86.145,39.7755,289,0,0.0,285,0.986159169550173,285,0.986159169550173,4,0.01384083044982699,9,0,0.0,8,0.8888888888888888,8,0.8888888888888888,1,0.1111111111111111
-86.145,39.776,292,0,0.0,292,1.0,292,1.0,0,0.0,6,0,0.0,6,1.0,6,1.0,0,0.0
-86.145,39.7765,382,0,0.0,382,1.0,382,1.0,0,0.0,6,0,0.0,6,1.0,6,1.0,0,0.0
-86.145,39.777,1521,0,0.0,1521,1.0,1521,1.0,0,0.0,7,0,0.0,7,1.0,7,1.0,0,0.0
-86.145,39.7775,1571,0,0.0,1571,1.0,1571,1.0,0,0.0,9,0,0.0,9,1.0,9,1.0,0,0.0
-86.145,39.778,263,0,0.0,263,1.0,263,1.0,0,0.0,4,0,0.0,4,1.0,4,1.0,0,0.0
-86.145,39.7785,439,0,0.0,439,1.0,439,1.0,0,0.0,4,0,0.0,4,1.0,4,1.0,0,0.0
-86.145,39.779,699,0,0.0,699,1.0,699,1.0,0,0.0,4,0,0.0,4,1.0,4,1.0,0,0.0
-86.145,39.7795,399,0,0.0,399,1.0,399,1.0,0,0.0,6,0,0.0,6,1.0,6,1.0,0,0.0
-86.145,39.78,1145,0,0.0,1126,0.9834061135371179,1126,0.9834061135371179,19,0.016593886462882096,14,0,0.0,10,0.7142857142857143,10,0.7142857142857143,4,0.2857142857142857
-86.145,39.7805,691,0,0.0,679,0.9826338639652678,679,0.9826338639652678,12,0.017366136034732273,10,0,0.0,7,0.7,7,0.7,3,0.3
