grid_lat,grid_lon,total_sample,mw_sample,mw_ratio,sub6_sample,sub6_ratio,5g_sample,5g_sample,lte_sample,lte_ratio,total_cs_sample,mw_cs_sample,mw_cs_ratio,sub6_cs_sample,sub6_cs_ratio,5g_cs_sample,5g_cs_sample,lte_cs_sample,lte_cs_ratio
-86.167,39.767,1,0,0.0,0,0.0,0,0.0,1,1.0,1,0,0.0,0,0.0,0,0.0,1,1.0
-86.1665,39.767,1447,0,0.0,1214,0.8389771941948859,1214,0.8389771941948859,233,0.16102280580511402,9,0,0.0,5,0.5555555555555556,5,0.5555555555555556,4,0.4444444444444444
-86.1665,39.7675,237,0,0.0,188,0.7932489451476793,188,0.7932489451476793,49,0.20675105485232068,7,0,0.0,3,0.42857142857142855,3,0.42857142857142855,4,0.5714285714285714
-86.1665,39.768,235,0,0.0,155,0.6595744680851063,155,0.6595744680851063,80,0.3404255319148936,6,0,0.0,3,0.5,3,0.5,3,0.5
-86.1665,39.7685,236,0,0.0,170,0.7203389830508474,170,0.7203389830508474,66,0.2796610169491525,2,0,0.0,1,0.5,1,0.5,1,0.5
-86.1665,39.769,411,0,0.0,177,0.4306569343065693,177,0.4306569343065693,234,0.5693430656934306,2,0,0.0,1,0.5,1,0.5,1,0.5
-86.1665,39.7695,632,0,0.0,229,0.3623417721518987,229,0.3623417721518987,403,0.6376582278481012,3,0,0.0,1,0.3333333333333333,1,0.3333333333333333,2,0.6666666666666666
-86.1665,39.77,799,0,0.0,721,0.9023779724655819,721,0.9023779724655819,78,0.09762202753441802,15,0,0.0,8,0.5333333333333333,8,0.5333333333333333,7,0.4666666666666667
-86.1665,39.7705,98,0,0.0,38,0.3877551020408163,38,0.3877551020408163,60,0.6122448979591837,4,0,0.0,2,0.5,2,0.5,2,0.5
-86.1665,39.771,573,0,0.0,512,0.893542757417103,512,0.893542757417103,61,0.10645724258289703,10,0,0.0,5,0.5,5,0.5,5,0.5
-86.1665,39.7715,2629,0,0.0,2586,0.9836439710916698,2586,0.9836439710916698,43,0.016356028908330163,6,0,0.0,4,0.6666666666666666,4,0.6666666666666666,2,0.3333333333333333
-86.1665,39.772,341,0,0.0,290,0.8504398826979472,290,0.8504398826979472,51,0.1495601173020528,9,0,0.0,6,0.6666666666666666,6,0.6666666666666666,3,0.3333333333333333
-86.1665,39.7725,708,0,0.0,304,0.4293785310734463,304,0.4293785310734463,404,0.5706214689265536,10,0,0.0,7,0.7,7,0.7,3,0.3
-86.1665,39.773,1914,0,0.0,1896,0.9905956112852664,1896,0.9905956112852664,18,0.009404388714733543,15,0,0.0,10,0.6666666666666666,10,0.6666666666666666,5,0.3333333333333333
-86.1665,39.7735,396,0,0.0,390,0.9848484848484849,390,0.9848484848484849,6,0.015151515151515152,10,0,0.0,8,0.8,8,0.8,2,0.2
-86.1665,39.774,1678,0,0.0,1628,0.9702026221692491,1628,0.9702026221692491,50,0.029797377830750895,10,0,0.0,9,0.9,9,0.9,1,0.1
-86.1665,39.7745,232,0,0.0,227,0.978448275862069,227,0.978448275862069,5,0.021551724137931036,5,0,0.0,3,0.6,3,0.6,2,0.4
-86.1665,39.775,1431,0,0.0,1099,0.7679944095038435,1099,0.7679944095038435,332,0.23200559049615654,7,0,0.0,6,0.8571428571428571,6,0.8571428571428571,1,0.14285714285714285
-86.1665,39.7755,224,0,0.0,171,0.7633928571428571,171,0.7633928571428571,53,0.23660714285714285,3,0,0.0,2,0.6666666666666666,2,0.6666666666666666,1,0.3333333333333333
-86.1665,39.776,172,0,0.0,129,0.75,129,0.75,43,0.25,3,0,0.0,2,0.6666666666666666,2,0.6666666666666666,1,0.3333333333333333
-86.1665,39.7765,154,0,0.0,114,0.7402597402597403,114,0.7402597402597403,40,0.2597402597402597,3,0,0.0,2,0.6666666666666666,2,0.6666666666666666,1,0.3333333333333333
-86.1665,39.777,64,0,0.0,47,0.734375,47,0.734375,17,0.265625,2,0,0.0,1,0.5,1,0.5,1,0.5
-86.166,39.767,346,0,0.0,289,0.8352601156069365,289,0.8352601156069365,57,0.16473988439306358,10,0,0.0,6,0.6,6,0.6,4,0.4
-86.166,39.77,189,0,0.0,189,1.0,189,1.0,0,0.0,2,0,0.0,2,1.0,2,1.0,0,0.0
-86.166,39.771,76,0,0.0,72,0.9473684210526315,72,0.9473684210526315,4,0.05263157894736842,5,0,0.0,4,0.8,4,0.8,1,0.2
-86.166,39.7715,139,0,0.0,131,0.9424460431654677,131,0.9424460431654677,8,0.05755395683453238,7,0,0.0,5,0.7142857142857143,5,0.7142857142857143,2,0.2857142857142857
-86.166,39.774,2007,0,0.0,2000,0.9965122072745392,2000,0.9965122072745392,7,0.003487792725460887,11,0,0.0,9,0.8181818181818182,9,0.8181818181818182,2,0.18181818181818182
-86.1655,39.767,304,0,0.0,265,0.8717105263157895,265,0.8717105263157895,39,0.12828947368421054,10,0,0.0,7,0.7,7,0.7,3,0.3
-86.1655,39.77,182,0,0.0,182,1.0,182,1.0,0,0.0,2,0,0.0,2,1.0,2,1.0,0,0.0
-86.1655,39.771,156,0,0.0,144,0.9230769230769231,144,0.9230769230769231,12,0.07692307692307693,10,0,0.0,7,0.7,7,0.7,3,0.3
-86.1655,39.7715,52,0,0.0,52,1.0,52,1.0,0,0.0,3,0,0.0,3,1.0,3,1.0,0,0.0
-86.1655,39.774,376,0,0.0,328,0.8723404255319149,328,0.8723404255319149,48,0.1276595744680851,19,0,0.0,14,0.7368421052631579,14,0.7368421052631579,5,0.2631578947368421
-86.165,39.767,632,0,0.0,590,0.9335443037974683,590,0.9335443037974683,42,0.06645569620253164,8,0,0.0,6,0.75,6,0.75,2,0.25
-86.165,39.7695,12,0,0.0,12,1.0,12,1.0,0,0.0,1,0,0.0,1,1.0,1,1.0,0,0.0
-86.165,39.77,169,0,0.0,169,1.0,169,1.0,0,0.0,2,0,0.0,2,1.0,2,1.0,0,0.0
-86.165,39.771,214,0,0.0,214,1.0,214,1.0,0,0.0,3,0,0.0,3,1.0,3,1.0,0,0.0
-86.165,39.774,376,0,0.0,339,0.901595744680851,339,0.901595744680851,37,0.09840425531914894,5,0,0.0,4,0.8,4,0.8,1,0.2
-86.1645,39.767,296,0,0.0,255,0.8614864864864865,255,0.8614864864864865,41,0.13851351351351351,8,0,0.0,5,0.625,5,0.625,3,0.375
-86.1645,39.7695,30,0,0.0,30,1.0,30,1.0,0,0.0,1,0,0.0,1,1.0,1,1.0,0,0.0
-86.1645,39.77,148,0,0.0,148,1.0,148,1.0,0,0.0,2,0,0.0,2,1.0,2,1.0,0,0.0
-86.1645,39.771,219,0,0.0,219,1.0,219,1.0,0,0.0,3,0,0.0,3,1.0,3,1.0,0,0.0
-86.1645,39.774,1767,0,0.0,1726,0.976796830786644,1726,0.976796830786644,41,0.02320316921335597,7,0,0.0,5,0.7142857142857143,5,0.7142857142857143,2,0.2857142857142857
-86.164,39.767,291,0,0.0,253,0.8694158075601375,253,0.8694158075601375,38,0.13058419243986255,7,0,0.0,5,0.7142857142857143,5,0.7142857142857143,2,0.2857142857142857
-86.164,39.7695,31,0,0.0,31,1.0,31,1.0,0,0.0,1,0,0.0,1,1.0,1,1.0,0,0.0
-86.164,39.77,146,0,0.0,146,1.0,146,1.0,0,0.0,2,0,0.0,2,1.0,2,1.0,0,0.0
-86.164,39.771,237,0,0.0,237,1.0,237,1.0,0,0.0,3,0,0.0,3,1.0,3,1.0,0,0.0
-86.164,39.774,367,0,0.0,311,0.8474114441416893,311,0.8474114441416893,56,0.15258855585831063,19,0,0.0,13,0.6842105263157895,13,0.6842105263157895,6,0.3157894736842105
-86.1635,39.767,300,0,0.0,267,0.89,267,0.89,33,0.11,6,0,0.0,5,0.8333333333333334,5,0.8333333333333334,1,0.16666666666666666
-86.1635,39.7695,1410,0,0.0,1331,0.9439716312056737,1331,0.9439716312056737,79,0.05602836879432624,3,0,0.0,2,0.6666666666666666,2,0.6666666666666666,1,0.3333333333333333
-86.1635,39.77,1410,0,0.0,1398,0.9914893617021276,1398,0.9914893617021276,12,0.00851063829787234,11,0,0.0,8,0.7272727272727273,8,0.7272727272727273,3,0.2727272727272727
-86.1635,39.7705,10,0,0.0,0,0.0,0,0.0,10,1.0,1,0,0.0,0,0.0,0,0.0,1,1.0
-86.1635,39.771,756,0,0.0,756,1.0,756,1.0,0,0.0,4,0,0.0,4,1.0,4,1.0,0,0.0
-86.1635,39.774,369,0,0.0,326,0.8834688346883469,326,0.8834688346883469,43,0.11653116531165311,9,0,0.0,7,0.7777777777777778,7,0.7777777777777778,2,0.2222222222222222
-86.163,39.767,637,0,0.0,567,0.8901098901098901,567,0.8901098901098901,70,0.10989010989010989,12,0,0.0,8,0.6666666666666666,8,0.6666666666666666,4,0.3333333333333333
-86.163,39.7695,55,0,0.0,55,1.0,55,1.0,0,0.0,3,0,0.0,3,1.0,3,1.0,0,0.0
-86.163,39.77,3358,0,0.0,2736,0.8147706968433591,2736,0.8147706968433591,622,0.18522930315664085,30,0,0.0,20,0.6666666666666666,20,0.6666666666666666,10,0.3333333333333333
-86.163,39.7705,1270,0,0.0,937,0.7377952755905511,937,0.7377952755905511,333,0.2622047244094488,30,0,0.0,20,0.6666666666666666,20,0.6666666666666666,10,0.3333333333333333
-86.163,39.771,5677,0,0.0,4463,0.7861546591509601,4463,0.7861546591509601,1214,0.21384534084903997,48,0,0.0,31,0.6458333333333334,31,0.6458333333333334,17,0.3541666666666667
-86.163,39.7715,6403,0,0.0,1131,0.17663595189754802,1131,0.17663595189754802,5272,0.823364048102452,9,0,0.0,5,0.5555555555555556,5,0.5555555555555556,4,0.4444444444444444
-86.163,39.772,1508,0,0.0,1003,0.6651193633952255,1003,0.6651193633952255,505,0.3348806366047745,11,0,0.0,11,1.0,11,1.0,0,0.0
-86.163,39.7725,9161,0,0.0,3339,0.3644798602772623,3339,0.3644798602772623,5822,0.6355201397227377,11,0,0.0,11,1.0,11,1.0,0,0.0
-86.163,39.773,1325,0,0.0,1316,0.9932075471698113,1316,0.9932075471698113,9,0.006792452830188679,9,0,0.0,7,0.7777777777777778,7,0.7777777777777778,2,0.2222222222222222
-86.163,39.7735,403,0,0.0,403,1.0,403,1.0,0,0.0,5,0,0.0,5,1.0,5,1.0,0,0.0
-86.163,39.774,899,0,0.0,828,0.9210233592880979,828,0.9210233592880979,71,0.07897664071190211,14,0,0.0,11,0.7857142857142857,11,0.7857142857142857,3,0.21428571428571427
-86.163,39.7745,468,0,0.0,412,0.8803418803418803,412,0.8803418803418803,56,0.11965811965811966,8,0,0.0,7,0.875,7,0.875,1,0.125
-86.163,39.775,785,0,0.0,729,0.9286624203821656,729,0.9286624203821656,56,0.07133757961783439,9,0,0.0,7,0.7777777777777778,7,0.7777777777777778,2,0.2222222222222222
-86.163,39.7755,856,0,0.0,790,0.9228971962616822,790,0.9228971962616822,66,0.07710280373831775,8,0,0.0,6,0.75,6,0.75,2,0.25
-86.163,39.776,419,0,0.0,363,0.8663484486873508,363,0.8663484486873508,56,0.13365155131264916,4,0,0.0,3,0.75,3,0.75,1,0.25
-86.163,39.7765,272,0,0.0,213,0.7830882352941176,213,0.7830882352941176,59,0.21691176470588236,4,0,0.0,3,0.75,3,0.75,1,0.25
-86.163,39.777,276,0,0.0,218,0.7898550724637681,218,0.7898550724637681,58,0.21014492753623187,4,0,0.0,3,0.75,3,0.75,1,0.25
-86.163,39.7775,281,0,0.0,223,0.7935943060498221,223,0.7935943060498221,58,0.20640569395017794,4,0,0.0,3,0.75,3,0.75,1,0.25
-86.1625,39.767,325,0,0.0,286,0.88,286,0.88,39,0.12,12,0,0.0,10,0.8333333333333334,10,0.8333333333333334,2,0.16666666666666666
-86.1625,39.7695,512,0,0.0,512,1.0,512,1.0,0,0.0,4,0,0.0,4,1.0,4,1.0,0,0.0
-86.1625,39.77,1191,0,0.0,929,0.780016792611251,929,0.780016792611251,262,0.21998320738874896,33,0,0.0,23,0.696969696969697,23,0.696969696969697,10,0.30303030303030304
-86.1625,39.771,1712,0,0.0,1146,0.669392523364486,1146,0.669392523364486,566,0.33060747663551404,15,0,0.0,9,0.6,9,0.6,6,0.4
-86.1625,39.7725,1490,0,0.0,193,0.12953020134228188,193,0.12953020134228188,1297,0.8704697986577181,5,0,0.0,5,1.0,5,1.0,0,0.0
-86.1625,39.774,265,0,0.0,265,1.0,265,1.0,0,0.0,2,0,0.0,2,1.0,2,1.0,0,0.0
-86.1625,39.7755,88,0,0.0,88,1.0,88,1.0,0,0.0,1,0,0.0,1,1.0,1,1.0,0,0.0
-86.162,39.767,352,0,0.0,303,0.8607954545454546,303,0.8607954545454546,49,0.13920454545454544,15,0,0.0,10,0.6666666666666666,10,0.6666666666666666,5,0.3333333333333333
-86.162,39.7695,260,0,0.0,229,0.8807692307692307,229,0.8807692307692307,31,0.11923076923076924,12,0,0.0,7,0.5833333333333334,7,0.5833333333333334,5,0.4166666666666667
-86.162,39.77,2557,0,0.0,2146,0.8392647633946031,2146,0.8392647633946031,411,0.16073523660539696,35,0,0.0,25,0.7142857142857143,25,0.7142857142857143,10,0.2857142857142857
-86.162,39.771,2537,0,0.0,978,0.3854946787544344,978,0.3854946787544344,1559,0.6145053212455657,32,0,0.0,24,0.75,24,0.75,8,0.25
-86.162,39.7725,516,0,0.0,154,0.29844961240310075,154,0.29844961240310075,362,0.7015503875968992,7,0,0.0,6,0.8571428571428571,6,0.8571428571428571,1,0.14285714285714285
-86.162,39.774,274,0,0.0,274,1.0,274,1.0,0,0.0,2,0,0.0,2,1.0,2,1.0,0,0.0
-86.162,39.7755,74,0,0.0,74,1.0,74,1.0,0,0.0,1,0,0.0,1,1.0,1,1.0,0,0.0
-86.1615,39.7665,246,0,0.0,151,0.6138211382113821,151,0.6138211382113821,95,0.3861788617886179,7,0,0.0,5,0.7142857142857143,5,0.7142857142857143,2,0.2857142857142857
-86.1615,39.767,1928,0,0.0,1655,0.858402489626556,1655,0.858402489626556,273,0.14159751037344398,29,0,0.0,20,0.6896551724137931,20,0.6896551724137931,9,0.3103448275862069
-86.1615,39.7675,323,0,0.0,211,0.653250773993808,211,0.653250773993808,112,0.34674922600619196,7,0,0.0,5,0.7142857142857143,5,0.7142857142857143,2,0.2857142857142857
-86.1615,39.768,289,0,0.0,185,0.6401384083044983,185,0.6401384083044983,104,0.35986159169550175,6,0,0.0,3,0.5,3,0.5,3,0.5
-86.1615,39.7685,360,0,0.0,268,0.7444444444444445,268,0.7444444444444445,92,0.25555555555555554,8,0,0.0,5,0.625,5,0.625,3,0.375
-86.1615,39.769,252,0,0.0,166,0.6587301587301587,166,0.6587301587301587,86,0.3412698412698413,3,0,0.0,2,0.6666666666666666,2,0.6666666666666666,1,0.3333333333333333
-86.1615,39.7695,2029,0,0.0,1756,0.8654509610645639,1756,0.8654509610645639,273,0.13454903893543618,10,0,0.0,7,0.7,7,0.7,3,0.3
-86.1615,39.77,5310,0,0.0,4045,0.7617702448210922,4045,0.7617702448210922,1265,0.2382297551789077,57,0,0.0,41,0.7192982456140351,41,0.7192982456140351,16,0.2807017543859649
-86.1615,39.7705,1605,0,0.0,1207,0.75202492211838,1207,0.75202492211838,398,0.24797507788161993,23,0,0.0,16,0.6956521739130435,16,0.6956521739130435,7,0.30434782608695654
-86.1615,39.771,9878,0,0.0,5144,0.5207531889046366,5144,0.5207531889046366,4734,0.47924681109536343,45,0,0.0,32,0.7111111111111111,32,0.7111111111111111,13,0.28888888888888886
-86.1615,39.7715,8749,0,0.0,6069,0.6936792776317293,6069,0.6936792776317293,2680,0.3063207223682707,21,0,0.0,15,0.7142857142857143,15,0.7142857142857143,6,0.2857142857142857
-86.1615,39.772,5940,0,0.0,3547,0.5971380471380472,3547,0.5971380471380472,2393,0.40286195286195287,32,0,0.0,16,0.5,16,0.5,16,0.5
-86.1615,39.7725,2491,0,0.0,1992,0.7996788438378162,1992,0.7996788438378162,499,0.20032115616218385,26,0,0.0,17,0.6538461538461539,17,0.6538461538461539,9,0.34615384615384615
-86.1615,39.773,217,0,0.0,214,0.9861751152073732,214,0.9861751152073732,3,0.013824884792626729,6,0,0.0,5,0.8333333333333334,5,0.8333333333333334,1,0.16666666666666666
-86.1615,39.7735,24,0,0.0,24,1.0,24,1.0,0,0.0,1,0,0.0,1,1.0,1,1.0,0,0.0
-86.1615,39.774,291,0,0.0,276,0.9484536082474226,276,0.9484536082474226,15,0.05154639175257732,12,0,0.0,9,0.75,9,0.75,3,0.25
-86.1615,39.7755,77,0,0.0,77,1.0,77,1.0,0,0.0,1,0,0.0,1,1.0,1,1.0,0,0.0
-86.161,39.767,910,0,0.0,857,0.9417582417582417,857,0.9417582417582417,53,0.05824175824175824,9,0,0.0,8,0.8888888888888888,8,0.8888888888888888,1,0.1111111111111111
-86.161,39.7695,321,0,0.0,321,1.0,321,1.0,0,0.0,9,0,0.0,9,1.0,9,1.0,0,0.0
-86.161,39.77,407,0,0.0,401,0.9852579852579852,401,0.9852579852579852,6,0.014742014742014743,5,0,0.0,4,0.8,4,0.8,1,0.2
-86.161,39.771,2214,0,0.0,1384,0.6251129177958447,1384,0.6251129177958447,830,0.3748870822041554,23,0,0.0,17,0.7391304347826086,17,0.7391304347826086,6,0.2608695652173913
-86.161,39.7715,2583,0,0.0,1843,0.713511420828494,1843,0.713511420828494,740,0.286488579171506,15,0,0.0,11,0.7333333333333333,11,0.7333333333333333,4,0.26666666666666666
-86.161,39.772,471,0,0.0,446,0.9469214437367304,446,0.9469214437367304,25,0.05307855626326964,9,0,0.0,7,0.7777777777777778,7,0.7777777777777778,2,0.2222222222222222
-86.161,39.7725,10276,0,0.0,6698,0.6518100428182172,6698,0.6518100428182172,3578,0.3481899571817828,34,0,0.0,24,0.7058823529411765,24,0.7058823529411765,10,0.29411764705882354
-86.161,39.773,168,0,0.0,164,0.9761904761904762,164,0.9761904761904762,4,0.023809523809523808,9,0,0.0,8,0.8888888888888888,8,0.8888888888888888,1,0.1111111111111111
-86.161,39.7735,271,0,0.0,260,0.959409594095941,260,0.959409594095941,11,0.04059040590405904,16,0,0.0,13,0.8125,13,0.8125,3,0.1875
-86.161,39.774,2670,0,0.0,2568,0.9617977528089887,2568,0.9617977528089887,102,0.038202247191011236,33,0,0.0,24,0.7272727272727273,24,0.7272727272727273,9,0.2727272727272727
-86.161,39.7745,244,0,0.0,219,0.8975409836065574,219,0.8975409836065574,25,0.10245901639344263,5,0,0.0,4,0.8,4,0.8,1,0.2
-86.161,39.775,222,0,0.0,222,1.0,222,1.0,0,0.0,3,0,0.0,3,1.0,3,1.0,0,0.0
-86.161,39.7755,1498,0,0.0,1494,0.9973297730307076,1494,0.9973297730307076,4,0.0026702269692923898,6,0,0.0,5,0.8333333333333334,5,0.8333333333333334,1,0.16666666666666666
-86.161,39.776,45,0,0.0,45,1.0,45,1.0,0,0.0,1,0,0.0,1,1.0,1,1.0,0,0.0
-86.161,39.7765,316,0,0.0,288,0.9113924050632911,288,0.9113924050632911,28,0.08860759493670886,6,0,0.0,3,0.5,3,0.5,3,0.5
-86.161,39.777,71,0,0.0,71,1.0,71,1.0,0,0.0,1,0,0.0,1,1.0,1,1.0,0,0.0
-86.161,39.7775,54,0,0.0,54,1.0,54,1.0,0,0.0,1,0,0.0,1,1.0,1,1.0,0,0.0
-86.1605,39.767,336,0,0.0,284,0.8452380952380952,284,0.8452380952380952,52,0.15476190476190477,14,0,0.0,12,0.8571428571428571,12,0.8571428571428571,2,0.14285714285714285
-86.1605,39.7695,338,0,0.0,338,1.0,338,1.0,0,0.0,7,0,0.0,7,1.0,7,1.0,0,0.0
-86.1605,39.77,413,0,0.0,403,0.9757869249394673,403,0.9757869249394673,10,0.024213075060532687,8,0,0.0,5,0.625,5,0.625,3,0.375
-86.1605,39.771,2022,0,0.0,1248,0.6172106824925816,1248,0.6172106824925816,774,0.3827893175074184,41,0,0.0,28,0.6829268292682927,28,0.6829268292682927,13,0.3170731707317073
-86.1605,39.7725,1781,0,0.0,1071,0.6013475575519371,1071,0.6013475575519371,710,0.39865244244806286,17,0,0.0,12,0.7058823529411765,12,0.7058823529411765,5,0.29411764705882354
-86.1605,39.774,402,0,0.0,393,0.9776119402985075,393,0.9776119402985075,9,0.022388059701492536,11,0,0.0,9,0.8181818181818182,9,0.8181818181818182,2,0.18181818181818182
-86.1605,39.7755,247,0,0.0,247,1.0,247,1.0,0,0.0,3,0,0.0,3,1.0,3,1.0,0,0.0
-86.16,39.767,303,0,0.0,263,0.8679867986798679,263,0.8679867986798679,40,0.132013201320132,12,0,0.0,11,0.9166666666666666,11,0.9166666666666666,1,0.08333333333333333
-86.16,39.7695,2743,0,0.0,2708,0.987240247903755,2708,0.987240247903755,35,0.012759752096244987,26,0,0.0,17,0.6538461538461539,17,0.6538461538461539,9,0.34615384615384615
-86.16,39.77,345,0,0.0,317,0.9188405797101449,317,0.9188405797101449,28,0.08115942028985507,13,0,0.0,8,0.6153846153846154,8,0.6153846153846154,5,0.38461538461538464
-86.16,39.771,3505,0,0.0,2597,0.7409415121255349,2597,0.7409415121255349,908,0.25905848787446506,37,0,0.0,27,0.7297297297297297,27,0.7297297297297297,10,0.2702702702702703
-86.16,39.7725,1628,0,0.0,934,0.5737100737100738,934,0.5737100737100738,694,0.4262899262899263,20,0,0.0,13,0.65,13,0.65,7,0.35
-86.16,39.774,353,0,0.0,346,0.9801699716713881,346,0.9801699716713881,7,0.019830028328611898,9,0,0.0,7,0.7777777777777778,7,0.7777777777777778,2,0.2222222222222222
-86.16,39.7755,187,0,0.0,182,0.9732620320855615,182,0.9732620320855615,5,0.026737967914438502,5,0,0.0,4,0.8,4,0.8,1,0.2
-86.1595,39.7665,142,0,0.0,142,1.0,142,1.0,0,0.0,1,0,0.0,1,1.0,1,1.0,0,0.0
-86.1595,39.767,4041,0,0.0,3869,0.957436278148973,3869,0.957436278148973,172,0.04256372185102698,27,0,0.0,23,0.8518518518518519,23,0.8518518518518519,4,0.14814814814814814
-86.1595,39.7675,305,0,0.0,237,0.7770491803278688,237,0.7770491803278688,68,0.22295081967213115,4,0,0.0,3,0.75,3,0.75,1,0.25
-86.1595,39.768,1284,0,0.0,1072,0.8348909657320872,1072,0.8348909657320872,212,0.16510903426791276,9,0,0.0,5,0.5555555555555556,5,0.5555555555555556,4,0.4444444444444444
-86.1595,39.7685,243,0,0.0,169,0.6954732510288066,169,0.6954732510288066,74,0.3045267489711934,7,0,0.0,5,0.7142857142857143,5,0.7142857142857143,2,0.2857142857142857
-86.1595,39.769,214,0,0.0,152,0.7102803738317757,152,0.7102803738317757,62,0.2897196261682243,2,0,0.0,2,1.0,2,1.0,0,0.0
-86.1595,39.7695,1282,0,0.0,1029,0.8026521060842434,1029,0.8026521060842434,253,0.19734789391575663,14,0,0.0,10,0.7142857142857143,10,0.7142857142857143,4,0.2857142857142857
-86.1595,39.77,800,0,0.0,728,0.91,728,0.91,72,0.09,16,0,0.0,12,0.75,12,0.75,4,0.25
-86.1595,39.7705,413,0,0.0,366,0.8861985472154964,366,0.8861985472154964,47,0.11380145278450363,3,0,0.0,3,1.0,3,1.0,0,0.0
-86.1595,39.771,14294,0,0.0,9929,0.6946271162725619,9929,0.6946271162725619,4365,0.3053728837274381,39,0,0.0,29,0.7435897435897436,29,0.7435897435897436,10,0.2564102564102564
-86.1595,39.7715,993,0,0.0,409,0.4118831822759315,409,0.4118831822759315,584,0.5881168177240684,3,0,0.0,3,1.0,3,1.0,0,0.0
-86.1595,39.772,1578,0,0.0,408,0.2585551330798479,408,0.2585551330798479,1170,0.7414448669201521,3,0,0.0,3,1.0,3,1.0,0,0.0
-86.1595,39.7725,6689,0,0.0,2980,0.4455075497084766,2980,0.4455075497084766,3709,0.5544924502915234,39,0,0.0,28,0.717948717948718,28,0.717948717948718,11,0.28205128205128205
-86.1595,39.773,14368,0,0.0,14211,0.9890729398663697,14211,0.9890729398663697,157,0.01092706013363029,40,0,0.0,23,0.575,23,0.575,17,0.425
-86.1595,39.7735,346,0,0.0,346,1.0,346,1.0,0,0.0,3,0,0.0,3,1.0,3,1.0,0,0.0
-86.1595,39.774,675,0,0.0,671,0.9940740740740741,671,0.9940740740740741,4,0.005925925925925926,10,0,0.0,9,0.9,9,0.9,1,0.1
-86.1595,39.7745,196,0,0.0,192,0.9795918367346939,192,0.9795918367346939,4,0.02040816326530612,9,0,0.0,8,0.8888888888888888,8,0.8888888888888888,1,0.1111111111111111
-86.1595,39.775,714,0,0.0,691,0.9677871148459384,691,0.9677871148459384,23,0.03221288515406162,13,0,0.0,9,0.6923076923076923,9,0.6923076923076923,4,0.3076923076923077
-86.1595,39.7755,20574,0,0.0,19759,0.9603868960824341,19759,0.9603868960824341,815,0.03961310391756586,67,0,0.0,38,0.5671641791044776,38,0.5671641791044776,29,0.43283582089552236
-86.1595,39.776,265,0,0.0,231,0.8716981132075472,231,0.8716981132075472,34,0.12830188679245283,5,0,0.0,4,0.8,4,0.8,1,0.2
-86.1595,39.7765,193,0,0.0,178,0.9222797927461139,178,0.9222797927461139,15,0.07772020725388601,8,0,0.0,6,0.75,6,0.75,2,0.25
-86.1595,39.777,173,0,0.0,169,0.976878612716763,169,0.976878612716763,4,0.023121387283236993,5,0,0.0,4,0.8,4,0.8,1,0.2
-86.1595,39.7775,13165,0,0.0,13009,0.9881503987846563,13009,0.9881503987846563,156,0.011849601215343715,41,0,0.0,22,0.5365853658536586,22,0.5365853658536586,19,0.4634146341463415
-86.159,39.767,943,0,0.0,812,0.8610816542948038,812,0.8610816542948038,131,0.13891834570519618,20,0,0.0,18,0.9,18,0.9,2,0.1
-86.159,39.7695,536,0,0.0,506,0.9440298507462687,506,0.9440298507462687,30,0.055970149253731345,26,0,0.0,19,0.7307692307692307,19,0.7307692307692307,7,0.2692307692307692
-86.159,39.77,59,0,0.0,59,1.0,59,1.0,0,0.0,2,0,0.0,2,1.0,2,1.0,0,0.0
-86.159,39.771,1358,0,0.0,1120,0.8247422680412371,1120,0.8247422680412371,238,0.17525773195876287,75,0,0.0,58,0.7733333333333333,58,0.7733333333333333,17,0.22666666666666666
-86.159,39.7725,5563,0,0.0,4689,0.8428905266942297,4689,0.8428905266942297,874,0.15710947330577027,26,0,0.0,21,0.8076923076923077,21,0.8076923076923077,5,0.19230769230769232
-86.159,39.774,699,0,0.0,689,0.9856938483547926,689,0.9856938483547926,10,0.01430615164520744,14,0,0.0,11,0.7857142857142857,11,0.7857142857142857,3,0.21428571428571427
-86.159,39.7755,947,0,0.0,404,0.426610348468849,404,0.426610348468849,543,0.573389651531151,15,0,0.0,11,0.7333333333333333,11,0.7333333333333333,4,0.26666666666666666
-86.159,39.776,56,0,0.0,50,0.8928571428571429,50,0.8928571428571429,6,0.10714285714285714,3,0,0.0,2,0.6666666666666666,2,0.6666666666666666,1,0.3333333333333333
-86.159,39.7765,935,0,0.0,530,0.5668449197860963,530,0.5668449197860963,405,0.43315508021390375,4,0,0.0,3,0.75,3,0.75,1,0.25
-86.159,39.777,194,0,0.0,139,0.7164948453608248,139,0.7164948453608248,55,0.28350515463917525,4,0,0.0,3,0.75,3,0.75,1,0.25
-86.159,39.7775,420,0,0.0,350,0.8333333333333334,350,0.8333333333333334,70,0.16666666666666666,11,0,0.0,9,0.8181818181818182,9,0.8181818181818182,2,0.18181818181818182
-86.1585,39.767,503,0,0.0,453,0.9005964214711729,453,0.9005964214711729,50,0.09940357852882704,15,0,0.0,12,0.8,12,0.8,3,0.2
-86.1585,39.768,361,0,0.0,353,0.9778393351800554,353,0.9778393351800554,8,0.0221606648199446,6,0,0.0,4,0.6666666666666666,4,0.6666666666666666,2,0.3333333333333333
-86.1585,39.7685,134,0,0.0,134,1.0,134,1.0,0,0.0,2,0,0.0,2,1.0,2,1.0,0,0.0
-86.1585,39.7695,489,0,0.0,489,1.0,489,1.0,0,0.0,4,0,0.0,4,1.0,4,1.0,0,0.0
-86.1585,39.77,10,0,0.0,10,1.0,10,1.0,0,0.0,1,0,0.0,1,1.0,1,1.0,0,0.0
-86.1585,39.771,1382,0,0.0,1180,0.85383502170767,1180,0.85383502170767,202,0.14616497829232997,23,0,0.0,19,0.8260869565217391,19,0.8260869565217391,4,0.17391304347826086
-86.1585,39.7725,1168,0,0.0,952,0.815068493150685,952,0.815068493150685,216,0.18493150684931506,34,0,0.0,26,0.7647058823529411,26,0.7647058823529411,8,0.23529411764705882
-86.1585,39.774,270,0,0.0,270,1.0,270,1.0,0,0.0,9,0,0.0,9,1.0,9,1.0,0,0.0
-86.1585,39.775,8,0,0.0,8,1.0,8,1.0,0,0.0,1,0,0.0,1,1.0,1,1.0,0,0.0
-86.1585,39.7755,250,0,0.0,210,0.84,210,0.84,40,0.16,6,0,0.0,5,0.8333333333333334,5,0.8333333333333334,1,0.16666666666666666
-86.1585,39.7775,258,0,0.0,221,0.8565891472868217,221,0.8565891472868217,37,0.1434108527131783,8,0,0.0,7,0.875,7,0.875,1,0.125
-86.158,39.7665,50,0,0.0,50,1.0,50,1.0,0,0.0,1,0,0.0,1,1.0,1,1.0,0,0.0
-86.158,39.767,1501,0,0.0,1363,0.9080612924716855,1363,0.9080612924716855,138,0.09193870752831446,27,0,0.0,19,0.7037037037037037,19,0.7037037037037037,8,0.2962962962962963
-86.158,39.7675,269,0,0.0,269,1.0,269,1.0,0,0.0,2,0,0.0,2,1.0,2,1.0,0,0.0
-86.158,39.768,114,0,0.0,114,1.0,114,1.0,0,0.0,2,0,0.0,2,1.0,2,1.0,0,0.0
-86.158,39.7685,53,0,0.0,53,1.0,53,1.0,0,0.0,2,0,0.0,2,1.0,2,1.0,0,0.0
-86.158,39.769,330,0,0.0,330,1.0,330,1.0,0,0.0,2,0,0.0,2,1.0,2,1.0,0,0.0
-86.158,39.7695,755,0,0.0,755,1.0,755,1.0,0,0.0,5,0,0.0,5,1.0,5,1.0,0,0.0
-86.158,39.77,1050,0,0.0,1044,0.9942857142857143,1044,0.9942857142857143,6,0.005714285714285714,5,0,0.0,4,0.8,4,0.8,1,0.2
-86.158,39.7705,305,0,0.0,305,1.0,305,1.0,0,0.0,2,0,0.0,2,1.0,2,1.0,0,0.0
-86.158,39.771,2581,0,0.0,2292,0.8880278961642775,2292,0.8880278961642775,289,0.11197210383572259,24,0,0.0,20,0.8333333333333334,20,0.8333333333333334,4,0.16666666666666666
-86.158,39.7715,23,0,0.0,23,1.0,23,1.0,0,0.0,1,0,0.0,1,1.0,1,1.0,0,0.0
-86.158,39.7725,1575,0,0.0,1295,0.8222222222222222,1295,0.8222222222222222,280,0.17777777777777778,70,0,0.0,62,0.8857142857142857,62,0.8857142857142857,8,0.11428571428571428
-86.158,39.774,282,0,0.0,282,1.0,282,1.0,0,0.0,9,0,0.0,9,1.0,9,1.0,0,0.0
-86.158,39.775,245,0,0.0,245,1.0,245,1.0,0,0.0,2,0,0.0,2,1.0,2,1.0,0,0.0
-86.158,39.7755,212,0,0.0,164,0.7735849056603774,164,0.7735849056603774,48,0.22641509433962265,8,0,0.0,6,0.75,6,0.75,2,0.25
-86.158,39.7775,429,0,0.0,373,0.8694638694638694,373,0.8694638694638694,56,0.13053613053613053,9,0,0.0,7,0.7777777777777778,7,0.7777777777777778,2,0.2222222222222222
-86.158,39.778,1,0,0.0,1,1.0,1,1.0,0,0.0,1,0,0.0,1,1.0,1,1.0,0,0.0
-86.1575,39.7665,94,0,0.0,94,1.0,94,1.0,0,0.0,1,0,0.0,1,1.0,1,1.0,0,0.0
-86.1575,39.767,3654,0,0.0,3042,0.8325123152709359,3042,0.8325123152709359,612,0.16748768472906403,41,0,0.0,29,0.7073170731707317,29,0.7073170731707317,12,0.2926829268292683
-86.1575,39.7695,195,0,0.0,195,1.0,195,1.0,0,0.0,1,0,0.0,1,1.0,1,1.0,0,0.0
-86.1575,39.77,61,0,0.0,61,1.0,61,1.0,0,0.0,1,0,0.0,1,1.0,1,1.0,0,0.0
-86.1575,39.7705,75,0,0.0,74,0.9866666666666667,74,0.9866666666666667,1,0.013333333333333334,4,0,0.0,3,0.75,3,0.75,1,0.25
-86.1575,39.771,1236,0,0.0,1088,0.8802588996763754,1088,0.8802588996763754,148,0.11974110032362459,27,0,0.0,22,0.8148148148148148,22,0.8148148148148148,5,0.18518518518518517
-86.1575,39.7715,2187,0,0.0,1911,0.8737997256515775,1911,0.8737997256515775,276,0.1262002743484225,19,0,0.0,16,0.8421052631578947,16,0.8421052631578947,3,0.15789473684210525
-86.1575,39.772,2786,0,0.0,2433,0.8732950466618808,2433,0.8732950466618808,353,0.12670495333811918,24,0,0.0,20,0.8333333333333334,20,0.8333333333333334,4,0.16666666666666666
-86.1575,39.7725,11485,0,0.0,9508,0.8278624292555508,9508,0.8278624292555508,1977,0.17213757074444927,39,0,0.0,34,0.8717948717948718,34,0.8717948717948718,5,0.1282051282051282
-86.1575,39.773,138,0,0.0,133,0.9637681159420289,133,0.9637681159420289,5,0.036231884057971016,6,0,0.0,5,0.8333333333333334,5,0.8333333333333334,1,0.16666666666666666
-86.1575,39.7735,151,0,0.0,151,1.0,151,1.0,0,0.0,3,0,0.0,3,1.0,3,1.0,0,0.0
-86.1575,39.774,5754,0,0.0,5486,0.9534237052485227,5486,0.9534237052485227,268,0.04657629475147723,50,0,0.0,44,0.88,44,0.88,6,0.12
-86.1575,39.7745,1047,0,0.0,1047,1.0,1047,1.0,0,0.0,15,0,0.0,15,1.0,15,1.0,0,0.0
-86.1575,39.775,1751,0,0.0,1742,0.9948600799543118,1742,0.9948600799543118,9,0.005139920045688178,15,0,0.0,13,0.8666666666666667,13,0.8666666666666667,2,0.13333333333333333
-86.1575,39.7755,549,0,0.0,384,0.6994535519125683,384,0.6994535519125683,165,0.3005464480874317,10,0,0.0,8,0.8,8,0.8,2,0.2
-86.1575,39.776,138,0,0.0,85,0.6159420289855072,85,0.6159420289855072,53,0.38405797101449274,3,0,0.0,2,0.6666666666666666,2,0.6666666666666666,1,0.3333333333333333
-86.1575,39.7765,130,0,0.0,85,0.6538461538461539,85,0.6538461538461539,45,0.34615384615384615,3,0,0.0,2,0.6666666666666666,2,0.6666666666666666,1,0.3333333333333333
-86.1575,39.777,445,0,0.0,124,0.2786516853932584,124,0.2786516853932584,321,0.7213483146067415,5,0,0.0,3,0.6,3,0.6,2,0.4
-86.1575,39.7775,6374,0,0.0,6037,0.9471289614057107,6037,0.9471289614057107,337,0.0528710385942893,11,0,0.0,9,0.8181818181818182,9,0.8181818181818182,2,0.18181818181818182
-86.157,39.7665,16,0,0.0,16,1.0,16,1.0,0,0.0,1,0,0.0,1,1.0,1,1.0,0,0.0
-86.157,39.767,796,0,0.0,706,0.8869346733668342,706,0.8869346733668342,90,0.11306532663316583,8,0,0.0,5,0.625,5,0.625,3,0.375
-86.157,39.7695,183,0,0.0,177,0.9672131147540983,177,0.9672131147540983,6,0.03278688524590164,6,0,0.0,4,0.6666666666666666,4,0.6666666666666666,2,0.3333333333333333
-86.157,39.771,160,0,0.0,160,1.0,160,1.0,0,0.0,2,0,0.0,2,1.0,2,1.0,0,0.0
-86.157,39.774,1182,0,0.0,1070,0.9052453468697124,1070,0.9052453468697124,112,0.09475465313028765,18,0,0.0,15,0.8333333333333334,15,0.8333333333333334,3,0.16666666666666666
-86.157,39.775,576,0,0.0,560,0.9722222222222222,560,0.9722222222222222,16,0.027777777777777776,11,0,0.0,10,0.9090909090909091,10,0.9090909090909091,1,0.09090909090909091
-86.157,39.7755,388,0,0.0,384,0.9896907216494846,384,0.9896907216494846,4,0.010309278350515464,7,0,0.0,6,0.8571428571428571,6,0.8571428571428571,1,0.14285714285714285
-86.157,39.7775,40,0,0.0,40,1.0,40,1.0,0,0.0,1,0,0.0,1,1.0,1,1.0,0,0.0
-86.1565,39.7665,80,0,0.0,80,1.0,80,1.0,0,0.0,2,0,0.0,2,1.0,2,1.0,0,0.0
-86.1565,39.767,438,0,0.0,382,0.8721461187214612,382,0.8721461187214612,56,0.1278538812785388,5,0,0.0,4,0.8,4,0.8,1,0.2
-86.1565,39.7695,226,0,0.0,201,0.8893805309734514,201,0.8893805309734514,25,0.11061946902654868,18,0,0.0,12,0.6666666666666666,12,0.6666666666666666,6,0.3333333333333333
-86.1565,39.771,186,0,0.0,167,0.8978494623655914,167,0.8978494623655914,19,0.10215053763440861,10,0,0.0,7,0.7,7,0.7,3,0.3
-86.1565,39.774,1574,0,0.0,1261,0.8011435832274459,1261,0.8011435832274459,313,0.198856416772554,23,0,0.0,17,0.7391304347826086,17,0.7391304347826086,6,0.2608695652173913
-86.1565,39.775,627,0,0.0,627,1.0,627,1.0,0,0.0,11,0,0.0,11,1.0,11,1.0,0,0.0
-86.1565,39.7755,112,0,0.0,112,1.0,112,1.0,0,0.0,4,0,0.0,4,1.0,4,1.0,0,0.0
-86.1565,39.7775,58,0,0.0,50,0.8620689655172413,50,0.8620689655172413,8,0.13793103448275862,6,0,0.0,4,0.6666666666666666,4,0.6666666666666666,2,0.3333333333333333
-86.156,39.7665,2274,0,0.0,1680,0.7387862796833773,1680,0.7387862796833773,594,0.2612137203166227,18,0,0.0,10,0.5555555555555556,10,0.5555555555555556,8,0.4444444444444444
-86.156,39.767,2899,0,0.0,1357,0.468092445670921,1357,0.468092445670921,1542,0.531907554329079,19,0,0.0,11,0.5789473684210527,11,0.5789473684210527,8,0.42105263157894735
-86.156,39.7675,1130,0,0.0,554,0.4902654867256637,554,0.4902654867256637,576,0.5097345132743363,18,0,0.0,9,0.5,9,0.5,9,0.5
-86.156,39.768,1517,0,0.0,857,0.5649307844429796,857,0.5649307844429796,660,0.43506921555702044,16,0,0.0,7,0.4375,7,0.4375,9,0.5625
-86.156,39.7685,4711,0,0.0,2853,0.6056039057524941,2853,0.6056039057524941,1858,0.3943960942475058,63,0,0.0,51,0.8095238095238095,51,0.8095238095238095,12,0.19047619047619047
-86.156,39.769,1199,0,0.0,756,0.6305254378648875,756,0.6305254378648875,443,0.3694745621351126,21,0,0.0,13,0.6190476190476191,13,0.6190476190476191,8,0.38095238095238093
-86.156,39.7695,5153,0,0.0,4694,0.9109256743644479,4694,0.9109256743644479,459,0.0890743256355521,23,0,0.0,15,0.6521739130434783,15,0.6521739130434783,8,0.34782608695652173
-86.156,39.77,116,0,0.0,66,0.5689655172413793,66,0.5689655172413793,50,0.43103448275862066,2,0,0.0,1,0.5,1,0.5,1,0.5
-86.156,39.7705,97,0,0.0,46,0.4742268041237113,46,0.4742268041237113,51,0.5257731958762887,3,0,0.0,2,0.6666666666666666,2,0.6666666666666666,1,0.3333333333333333
-86.156,39.771,1121,0,0.0,883,0.7876895628902766,883,0.7876895628902766,238,0.21231043710972347,35,0,0.0,30,0.8571428571428571,30,0.8571428571428571,5,0.14285714285714285
-86.156,39.7715,1789,0,0.0,1201,0.6713247624371157,1201,0.6713247624371157,588,0.3286752375628843,47,0,0.0,36,0.7659574468085106,36,0.7659574468085106,11,0.23404255319148937
-86.156,39.772,809,0,0.0,390,0.4820766378244747,390,0.4820766378244747,419,0.5179233621755254,30,0,0.0,15,0.5,15,0.5,15,0.5
-86.156,39.7725,1045,0,0.0,589,0.5636363636363636,589,0.5636363636363636,456,0.43636363636363634,23,0,0.0,13,0.5652173913043478,13,0.5652173913043478,10,0.43478260869565216
-86.156,39.773,1137,0,0.0,515,0.4529463500439754,515,0.4529463500439754,622,0.5470536499560247,14,0,0.0,8,0.5714285714285714,8,0.5714285714285714,6,0.42857142857142855
-86.156,39.7735,849,0,0.0,381,0.44876325088339225,381,0.44876325088339225,468,0.5512367491166078,10,0,0.0,5,0.5,5,0.5,5,0.5
-86.156,39.774,5112,0,0.0,3487,0.6821205007824727,3487,0.6821205007824727,1625,0.3178794992175274,22,0,0.0,15,0.6818181818181818,15,0.6818181818181818,7,0.3181818181818182
-86.156,39.7745,1515,0,0.0,1129,0.7452145214521452,1129,0.7452145214521452,386,0.25478547854785477,13,0,0.0,8,0.6153846153846154,8,0.6153846153846154,5,0.38461538461538464
-86.156,39.775,9821,0,0.0,7927,0.8071479482741065,7927,0.8071479482741065,1894,0.19285205172589348,54,0,0.0,35,0.6481481481481481,35,0.6481481481481481,19,0.35185185185185186
-86.156,39.7755,82,0,0.0,82,1.0,82,1.0,0,0.0,3,0,0.0,3,1.0,3,1.0,0,0.0
-86.156,39.7775,244,0,0.0,244,1.0,244,1.0,0,0.0,3,0,0.0,3,1.0,3,1.0,0,0.0
-86.1555,39.7665,2300,0,0.0,2300,1.0,2300,1.0,0,0.0,3,0,0.0,3,1.0,3,1.0,0,0.0
-86.1555,39.767,381,0,0.0,381,1.0,381,1.0,0,0.0,4,0,0.0,4,1.0,4,1.0,0,0.0
-86.1555,39.768,61,0,0.0,0,0.0,0,0.0,61,1.0,1,0,0.0,0,0.0,0,0.0,1,1.0
-86.1555,39.7695,1746,0,0.0,1179,0.6752577319587629,1179,0.6752577319587629,567,0.3247422680412371,34,0,0.0,23,0.6764705882352942,23,0.6764705882352942,11,0.3235294117647059
-86.1555,39.77,60,0,0.0,60,1.0,60,1.0,0,0.0,2,0,0.0,2,1.0,2,1.0,0,0.0
-86.1555,39.771,1103,0,0.0,989,0.8966455122393472,989,0.8966455122393472,114,0.10335448776065277,33,0,0.0,25,0.7575757575757576,25,0.7575757575757576,8,0.24242424242424243
-86.1555,39.7715,153,0,0.0,138,0.9019607843137255,138,0.9019607843137255,15,0.09803921568627451,5,0,0.0,4,0.8,4,0.8,1,0.2
-86.1555,39.772,76,0,0.0,39,0.5131578947368421,39,0.5131578947368421,37,0.4868421052631579,4,0,0.0,3,0.75,3,0.75,1,0.25
-86.1555,39.7725,149,0,0.0,84,0.5637583892617449,84,0.5637583892617449,65,0.436241610738255,3,0,0.0,2,0.6666666666666666,2,0.6666666666666666,1,0.3333333333333333
-86.1555,39.7735,87,0,0.0,77,0.8850574712643678,77,0.8850574712643678,10,0.11494252873563218,3,0,0.0,2,0.6666666666666666,2,0.6666666666666666,1,0.3333333333333333
-86.1555,39.774,2049,0,0.0,1590,0.7759882869692533,1590,0.7759882869692533,459,0.2240117130307467,20,0,0.0,15,0.75,15,0.75,5,0.25
-86.1555,39.7745,618,0,0.0,308,0.49838187702265374,308,0.49838187702265374,310,0.5016181229773463,11,0,0.0,6,0.5454545454545454,6,0.5454545454545454,5,0.45454545454545453
-86.1555,39.775,5169,0,0.0,3373,0.6525440123815052,3373,0.6525440123815052,1796,0.3474559876184949,33,0,0.0,21,0.6363636363636364,21,0.6363636363636364,12,0.36363636363636365
-86.1555,39.7755,2672,0,0.0,1168,0.437125748502994,1168,0.437125748502994,1504,0.562874251497006,23,0,0.0,13,0.5652173913043478,13,0.5652173913043478,10,0.43478260869565216
-86.1555,39.776,96,0,0.0,46,0.4791666666666667,46,0.4791666666666667,50,0.5208333333333334,2,0,0.0,1,0.5,1,0.5,1,0.5
-86.1555,39.7765,179,0,0.0,171,0.9553072625698324,171,0.9553072625698324,8,0.0446927374301676,3,0,0.0,2,0.6666666666666666,2,0.6666666666666666,1,0.3333333333333333
-86.1555,39.777,47,0,0.0,35,0.7446808510638298,35,0.7446808510638298,12,0.2553191489361702,5,0,0.0,3,0.6,3,0.6,2,0.4
-86.1555,39.7775,120,0,0.0,115,0.9583333333333334,115,0.9583333333333334,5,0.041666666666666664,4,0,0.0,3,0.75,3,0.75,1,0.25
-86.155,39.7665,506,0,0.0,506,1.0,506,1.0,0,0.0,3,0,0.0,3,1.0,3,1.0,0,0.0
-86.155,39.767,84,0,0.0,84,1.0,84,1.0,0,0.0,2,0,0.0,2,1.0,2,1.0,0,0.0
-86.155,39.768,43,0,0.0,0,0.0,0,0.0,43,1.0,1,0,0.0,0,0.0,0,0.0,1,1.0
-86.155,39.7695,886,0,0.0,557,0.628668171557562,557,0.628668171557562,329,0.37133182844243795,27,0,0.0,16,0.5925925925925926,16,0.5925925925925926,11,0.4074074074074074
-86.155,39.77,81,0,0.0,81,1.0,81,1.0,0,0.0,5,0,0.0,5,1.0,5,1.0,0,0.0
-86.155,39.771,882,0,0.0,714,0.8095238095238095,714,0.8095238095238095,168,0.19047619047619047,18,0,0.0,12,0.6666666666666666,12,0.6666666666666666,6,0.3333333333333333
-86.155,39.7715,42,0,0.0,42,1.0,42,1.0,0,0.0,1,0,0.0,1,1.0,1,1.0,0,0.0
-86.155,39.7725,56,0,0.0,0,0.0,0,0.0,56,1.0,1,0,0.0,0,0.0,0,0.0,1,1.0
-86.155,39.774,199,0,0.0,195,0.9798994974874372,195,0.9798994974874372,4,0.020100502512562814,4,0,0.0,3,0.75,3,0.75,1,0.25
-86.155,39.775,1135,0,0.0,952,0.8387665198237886,952,0.8387665198237886,183,0.16123348017621145,17,0,0.0,12,0.7058823529411765,12,0.7058823529411765,5,0.29411764705882354
-86.155,39.7755,1099,0,0.0,216,0.19654231119199272,216,0.19654231119199272,883,0.8034576888080073,7,0,0.0,4,0.5714285714285714,4,0.5714285714285714,3,0.42857142857142855
-86.155,39.7765,45,0,0.0,45,1.0,45,1.0,0,0.0,1,0,0.0,1,1.0,1,1.0,0,0.0
-86.155,39.7775,39,0,0.0,35,0.8974358974358975,35,0.8974358974358975,4,0.10256410256410256,2,0,0.0,1,0.5,1,0.5,1,0.5
-86.1545,39.7665,5614,0,0.0,4317,0.7689704310651941,4317,0.7689704310651941,1297,0.23102956893480583,70,0,0.0,57,0.8142857142857143,57,0.8142857142857143,13,0.18571428571428572
-86.1545,39.767,1197,0,0.0,690,0.5764411027568922,690,0.5764411027568922,507,0.42355889724310775,20,0,0.0,15,0.75,15,0.75,5,0.25
-86.1545,39.7675,1197,0,0.0,196,0.16374269005847952,196,0.16374269005847952,1001,0.8362573099415205,8,0,0.0,2,0.25,2,0.25,6,0.75
-86.1545,39.768,218,0,0.0,62,0.28440366972477066,62,0.28440366972477066,156,0.7155963302752294,5,0,0.0,1,0.2,1,0.2,4,0.8
-86.1545,39.7685,44,0,0.0,44,1.0,44,1.0,0,0.0,1,0,0.0,1,1.0,1,1.0,0,0.0
-86.1545,39.769,1,0,0.0,1,1.0,1,1.0,0,0.0,1,0,0.0,1,1.0,1,1.0,0,0.0
-86.1545,39.7695,2225,0,0.0,1835,0.8247191011235955,1835,0.8247191011235955,390,0.1752808988764045,46,0,0.0,31,0.6739130434782609,31,0.6739130434782609,15,0.32608695652173914
-86.1545,39.77,16,0,0.0,16,1.0,16,1.0,0,0.0,1,0,0.0,1,1.0,1,1.0,0,0.0
-86.1545,39.771,4401,0,0.0,3547,0.80595319245626,3547,0.80595319245626,854,0.19404680754374007,48,0,0.0,34,0.7083333333333334,34,0.7083333333333334,14,0.2916666666666667
-86.1545,39.7715,229,0,0.0,164,0.7161572052401747,164,0.7161572052401747,65,0.2838427947598253,3,0,0.0,2,0.6666666666666666,2,0.6666666666666666,1,0.3333333333333333
-86.1545,39.7725,57,0,0.0,0,0.0,0,0.0,57,1.0,1,0,0.0,0,0.0,0,0.0,1,1.0
-86.1545,39.774,1288,0,0.0,1285,0.9976708074534162,1285,0.9976708074534162,3,0.002329192546583851,6,0,0.0,5,0.8333333333333334,5,0.8333333333333334,1,0.16666666666666666
-86.1545,39.775,579,0,0.0,418,0.7219343696027634,418,0.7219343696027634,161,0.27806563039723664,14,0,0.0,11,0.7857142857142857,11,0.7857142857142857,3,0.21428571428571427
-86.1545,39.7755,29,0,0.0,29,1.0,29,1.0,0,0.0,1,0,0.0,1,1.0,1,1.0,0,0.0
-86.1545,39.7765,40,0,0.0,40,1.0,40,1.0,0,0.0,1,0,0.0,1,1.0,1,1.0,0,0.0
-86.1545,39.7775,41,0,0.0,41,1.0,41,1.0,0,0.0,1,0,0.0,1,1.0,1,1.0,0,0.0
-86.154,39.7665,1521,0,0.0,1084,0.7126890203813281,1084,0.7126890203813281,437,0.2873109796186719,13,0,0.0,10,0.7692307692307693,10,0.7692307692307693,3,0.23076923076923078
-86.154,39.767,16889,0,0.0,6211,0.3677541595121085,6211,0.3677541595121085,10678,0.6322458404878916,43,0,0.0,28,0.6511627906976745,28,0.6511627906976745,15,0.3488372093023256
-86.154,39.7675,2552,0,0.0,1573,0.6163793103448276,1573,0.6163793103448276,979,0.38362068965517243,33,0,0.0,23,0.696969696969697,23,0.696969696969697,10,0.30303030303030304
-86.154,39.768,2808,0,0.0,1743,0.6207264957264957,1743,0.6207264957264957,1065,0.37927350427350426,43,0,0.0,29,0.6744186046511628,29,0.6744186046511628,14,0.32558139534883723
-86.154,39.7685,2724,0,0.0,1649,0.605359765051395,1649,0.605359765051395,1075,0.394640234948605,49,0,0.0,32,0.6530612244897959,32,0.6530612244897959,17,0.3469387755102041
-86.154,39.769,3763,0,0.0,2449,0.6508105235184694,2449,0.6508105235184694,1314,0.3491894764815307,62,0,0.0,30,0.4838709677419355,30,0.4838709677419355,32,0.5161290322580645
-86.154,39.7695,9892,0,0.0,5419,0.5478164173069147,5419,0.5478164173069147,4473,0.45218358269308534,79,0,0.0,46,0.5822784810126582,46,0.5822784810126582,33,0.4177215189873418
-86.154,39.77,1812,0,0.0,807,0.445364238410596,807,0.445364238410596,1005,0.554635761589404,58,0,0.0,24,0.41379310344827586,24,0.41379310344827586,34,0.5862068965517241
-86.154,39.7705,2164,0,0.0,948,0.43807763401109057,948,0.43807763401109057,1216,0.5619223659889094,38,0,0.0,16,0.42105263157894735,16,0.42105263157894735,22,0.5789473684210527
-86.154,39.771,3855,0,0.0,2129,0.5522697795071336,2129,0.5522697795071336,1726,0.4477302204928664,35,0,0.0,23,0.6571428571428571,23,0.6571428571428571,12,0.34285714285714286
-86.154,39.7715,1773,0,0.0,1099,0.6198533558939651,1099,0.6198533558939651,674,0.380146644106035,30,0,0.0,17,0.5666666666666667,17,0.5666666666666667,13,0.43333333333333335
-86.154,39.772,7568,0,0.0,5807,0.7673097251585623,5807,0.7673097251585623,1761,0.23269027484143764,39,0,0.0,22,0.5641025641025641,22,0.5641025641025641,17,0.4358974358974359
-86.154,39.7725,2424,0,0.0,1452,0.599009900990099,1452,0.599009900990099,972,0.400990099009901,31,0,0.0,20,0.6451612903225806,20,0.6451612903225806,11,0.3548387096774194
-86.154,39.773,873,0,0.0,726,0.8316151202749141,726,0.8316151202749141,147,0.16838487972508592,13,0,0.0,11,0.8461538461538461,11,0.8461538461538461,2,0.15384615384615385
-86.154,39.7735,1949,0,0.0,1719,0.8819907644946127,1719,0.8819907644946127,230,0.11800923550538737,22,0,0.0,18,0.8181818181818182,18,0.8181818181818182,4,0.18181818181818182
-86.154,39.774,1495,0,0.0,1364,0.9123745819397994,1364,0.9123745819397994,131,0.08762541806020067,38,0,0.0,32,0.8421052631578947,32,0.8421052631578947,6,0.15789473684210525
-86.154,39.7745,694,0,0.0,524,0.7550432276657061,524,0.7550432276657061,170,0.24495677233429394,17,0,0.0,12,0.7058823529411765,12,0.7058823529411765,5,0.29411764705882354
-86.154,39.775,1621,0,0.0,1160,0.7156076495990129,1160,0.7156076495990129,461,0.28439235040098704,24,0,0.0,15,0.625,15,0.625,9,0.375
-86.154,39.7755,240,0,0.0,0,0.0,0,0.0,240,1.0,4,0,0.0,0,0.0,0,0.0,4,1.0
-86.154,39.776,275,0,0.0,0,0.0,0,0.0,275,1.0,4,0,0.0,0,0.0,0,0.0,4,1.0
-86.154,39.7765,706,0,0.0,69,0.09773371104815864,69,0.09773371104815864,637,0.9022662889518414,5,0,0.0,1,0.2,1,0.2,4,0.8
-86.154,39.777,25,0,0.0,0,0.0,0,0.0,25,1.0,1,0,0.0,0,0.0,0,0.0,1,1.0
-86.154,39.7775,252,0,0.0,252,1.0,252,1.0,0,0.0,2,0,0.0,2,1.0,2,1.0,0,0.0
-86.1535,39.7665,1558,0,0.0,1447,0.9287548138639281,1447,0.9287548138639281,111,0.07124518613607189,11,0,0.0,7,0.6363636363636364,7,0.6363636363636364,4,0.36363636363636365
-86.1535,39.767,1852,0,0.0,1035,0.5588552915766739,1035,0.5588552915766739,817,0.44114470842332615,16,0,0.0,10,0.625,10,0.625,6,0.375
-86.1535,39.7695,176,0,0.0,176,1.0,176,1.0,0,0.0,1,0,0.0,1,1.0,1,1.0,0,0.0
-86.1535,39.771,814,0,0.0,388,0.47665847665847666,388,0.47665847665847666,426,0.5233415233415234,15,0,0.0,10,0.6666666666666666,10,0.6666666666666666,5,0.3333333333333333
-86.1535,39.772,14,0,0.0,0,0.0,0,0.0,14,1.0,1,0,0.0,0,0.0,0,0.0,1,1.0
-86.1535,39.7725,786,0,0.0,321,0.4083969465648855,321,0.4083969465648855,465,0.5916030534351145,13,0,0.0,6,0.46153846153846156,6,0.46153846153846156,7,0.5384615384615384
-86.1535,39.774,577,0,0.0,566,0.9809358752166378,566,0.9809358752166378,11,0.019064124783362217,8,0,0.0,6,0.75,6,0.75,2,0.25
-86.1535,39.775,571,0,0.0,367,0.6427320490367776,367,0.6427320490367776,204,0.3572679509632224,4,0,0.0,1,0.25,1,0.25,3,0.75
-86.1535,39.7765,6,0,0.0,0,0.0,0,0.0,6,1.0,2,0,0.0,0,0.0,0,0.0,2,1.0
-86.1535,39.777,123,0,0.0,0,0.0,0,0.0,123,1.0,3,0,0.0,0,0.0,0,0.0,3,1.0
-86.1535,39.7775,184,0,0.0,37,0.20108695652173914,37,0.20108695652173914,147,0.7989130434782609,6,0,0.0,3,0.5,3,0.5,3,0.5
-86.153,39.7665,1056,0,0.0,662,0.6268939393939394,662,0.6268939393939394,394,0.3731060606060606,17,0,0.0,10,0.5882352941176471,10,0.5882352941176471,7,0.4117647058823529
-86.153,39.767,2798,0,0.0,1883,0.6729807005003574,1883,0.6729807005003574,915,0.3270192994996426,21,0,0.0,13,0.6190476190476191,13,0.6190476190476191,8,0.38095238095238093
-86.153,39.7695,212,0,0.0,206,0.9716981132075472,206,0.9716981132075472,6,0.02830188679245283,3,0,0.0,2,0.6666666666666666,2,0.6666666666666666,1,0.3333333333333333
-86.153,39.771,782,0,0.0,361,0.4616368286445013,361,0.4616368286445013,421,0.5383631713554987,13,0,0.0,8,0.6153846153846154,8,0.6153846153846154,5,0.38461538461538464
-86.153,39.7725,862,0,0.0,333,0.3863109048723898,333,0.3863109048723898,529,0.6136890951276102,11,0,0.0,6,0.5454545454545454,6,0.5454545454545454,5,0.45454545454545453
-86.153,39.774,234,0,0.0,234,1.0,234,1.0,0,0.0,4,0,0.0,4,1.0,4,1.0,0,0.0
-86.153,39.775,175,0,0.0,36,0.2057142857142857,36,0.2057142857142857,139,0.7942857142857143,4,0,0.0,1,0.25,1,0.25,3,0.75
-86.153,39.7775,38,0,0.0,38,1.0,38,1.0,0,0.0,1,0,0.0,1,1.0,1,1.0,0,0.0
-86.1525,39.7665,655,0,0.0,419,0.6396946564885496,419,0.6396946564885496,236,0.3603053435114504,19,0,0.0,12,0.631578947368421,12,0.631578947368421,7,0.3684210526315789
-86.1525,39.767,6237,0,0.0,3604,0.5778419111752445,3604,0.5778419111752445,2633,0.4221580888247555,78,0,0.0,43,0.5512820512820513,43,0.5512820512820513,35,0.44871794871794873
-86.1525,39.7675,2054,0,0.0,867,0.42210321324245376,867,0.42210321324245376,1187,0.5778967867575463,42,0,0.0,17,0.40476190476190477,17,0.40476190476190477,25,0.5952380952380952
-86.1525,39.768,2247,0,0.0,919,0.40898976412995103,919,0.40898976412995103,1328,0.591010235870049,23,0,0.0,13,0.5652173913043478,13,0.5652173913043478,10,0.43478260869565216
-86.1525,39.7685,2974,0,0.0,1062,0.35709482178883656,1062,0.35709482178883656,1912,0.6429051782111634,31,0,0.0,18,0.5806451612903226,18,0.5806451612903226,13,0.41935483870967744
-86.1525,39.769,1848,0,0.0,459,0.2483766233766234,459,0.2483766233766234,1389,0.7516233766233766,21,0,0.0,7,0.3333333333333333,7,0.3333333333333333,14,0.6666666666666666
-86.1525,39.7695,6083,0,0.0,3779,0.6212395199736972,3779,0.6212395199736972,2304,0.3787604800263028,44,0,0.0,21,0.4772727272727273,21,0.4772727272727273,23,0.5227272727272727
-86.1525,39.77,3593,0,0.0,1996,0.5555246312273866,1996,0.5555246312273866,1597,0.4444753687726134,54,0,0.0,24,0.4444444444444444,24,0.4444444444444444,30,0.5555555555555556
-86.1525,39.7705,1826,0,0.0,1136,0.6221248630887185,1136,0.6221248630887185,690,0.3778751369112815,24,0,0.0,16,0.6666666666666666,16,0.6666666666666666,8,0.3333333333333333
-86.1525,39.771,11267,0,0.0,7368,0.6539451495517884,7368,0.6539451495517884,3899,0.3460548504482116,53,0,0.0,42,0.7924528301886793,42,0.7924528301886793,11,0.20754716981132076
-86.1525,39.7715,984,0,0.0,831,0.8445121951219512,831,0.8445121951219512,153,0.15548780487804878,17,0,0.0,15,0.8823529411764706,15,0.8823529411764706,2,0.11764705882352941
-86.1525,39.772,638,0,0.0,540,0.8463949843260188,540,0.8463949843260188,98,0.1536050156739812,15,0,0.0,13,0.8666666666666667,13,0.8666666666666667,2,0.13333333333333333
-86.1525,39.7725,2592,0,0.0,1705,0.6577932098765432,1705,0.6577932098765432,887,0.3422067901234568,26,0,0.0,17,0.6538461538461539,17,0.6538461538461539,9,0.34615384615384615
-86.1525,39.7735,1955,0,0.0,1950,0.9974424552429667,1950,0.9974424552429667,5,0.0025575447570332483,5,0,0.0,3,0.6,3,0.6,2,0.4
-86.1525,39.774,168,0,0.0,168,1.0,168,1.0,0,0.0,3,0,0.0,3,1.0,3,1.0,0,0.0
-86.1525,39.775,225,0,0.0,125,0.5555555555555556,125,0.5555555555555556,100,0.4444444444444444,6,0,0.0,2,0.3333333333333333,2,0.3333333333333333,4,0.6666666666666666
-86.1525,39.7775,40,0,0.0,40,1.0,40,1.0,0,0.0,1,0,0.0,1,1.0,1,1.0,0,0.0
-86.152,39.7665,171,0,0.0,122,0.7134502923976608,122,0.7134502923976608,49,0.28654970760233917,4,0,0.0,3,0.75,3,0.75,1,0.25
-86.152,39.768,59,0,0.0,59,1.0,59,1.0,0,0.0,1,0,0.0,1,1.0,1,1.0,0,0.0
-86.152,39.7695,268,0,0.0,218,0.8134328358208955,218,0.8134328358208955,50,0.1865671641791045,3,0,0.0,2,0.6666666666666666,2,0.6666666666666666,1,0.3333333333333333
-86.152,39.7705,3,0,0.0,0,0.0,0,0.0,3,1.0,1,0,0.0,0,0.0,0,0.0,1,1.0
-86.152,39.771,7584,0,0.0,7099,0.9360495780590717,7099,0.9360495780590717,485,0.06395042194092827,67,0,0.0,61,0.9104477611940298,61,0.9104477611940298,6,0.08955223880597014
-86.152,39.7715,4145,0,0.0,3793,0.9150784077201447,3793,0.9150784077201447,352,0.08492159227985525,53,0,0.0,48,0.9056603773584906,48,0.9056603773584906,5,0.09433962264150944
-86.152,39.772,3064,0,0.0,2715,0.8860966057441253,2715,0.8860966057441253,349,0.11390339425587467,107,0,0.0,98,0.9158878504672897,98,0.9158878504672897,9,0.08411214953271028
-86.152,39.7725,9358,0,0.0,8212,0.8775379354562941,8212,0.8775379354562941,1146,0.12246206454370592,47,0,0.0,40,0.851063829787234,40,0.851063829787234,7,0.14893617021276595
-86.152,39.773,3640,0,0.0,3293,0.9046703296703297,3293,0.9046703296703297,347,0.09532967032967032,76,0,0.0,70,0.9210526315789473,70,0.9210526315789473,6,0.07894736842105263
-86.152,39.7735,17589,0,0.0,15920,0.905111149013588,15920,0.905111149013588,1669,0.09488885098641196,81,0,0.0,74,0.9135802469135802,74,0.9135802469135802,7,0.08641975308641975
-86.152,39.774,647,0,0.0,462,0.714064914992272,462,0.714064914992272,185,0.28593508500772796,4,0,0.0,3,0.75,3,0.75,1,0.25
-86.152,39.7745,153,0,0.0,152,0.9934640522875817,152,0.9934640522875817,1,0.006535947712418301,4,0,0.0,3,0.75,3,0.75,1,0.25
-86.152,39.775,988,0,0.0,900,0.9109311740890689,900,0.9109311740890689,88,0.08906882591093117,8,0,0.0,6,0.75,6,0.75,2,0.25
-86.152,39.7755,864,0,0.0,751,0.8692129629629629,751,0.8692129629629629,113,0.13078703703703703,9,0,0.0,6,0.6666666666666666,6,0.6666666666666666,3,0.3333333333333333
-86.152,39.776,248,0,0.0,162,0.6532258064516129,162,0.6532258064516129,86,0.3467741935483871,8,0,0.0,4,0.5,4,0.5,4,0.5
-86.152,39.7765,206,0,0.0,125,0.6067961165048543,125,0.6067961165048543,81,0.3932038834951456,11,0,0.0,7,0.6363636363636364,7,0.6363636363636364,4,0.36363636363636365
-86.152,39.777,214,0,0.0,128,0.5981308411214953,128,0.5981308411214953,86,0.40186915887850466,4,0,0.0,2,0.5,2,0.5,2,0.5
-86.152,39.7775,313,0,0.0,216,0.6900958466453674,216,0.6900958466453674,97,0.30990415335463256,9,0,0.0,7,0.7777777777777778,7,0.7777777777777778,2,0.2222222222222222
-86.1515,39.7665,149,0,0.0,105,0.7046979865771812,105,0.7046979865771812,44,0.2953020134228188,4,0,0.0,3,0.75,3,0.75,1,0.25
-86.1515,39.768,40,0,0.0,40,1.0,40,1.0,0,0.0,1,0,0.0,1,1.0,1,1.0,0,0.0
-86.1515,39.7695,241,0,0.0,209,0.8672199170124482,209,0.8672199170124482,32,0.13278008298755187,3,0,0.0,2,0.6666666666666666,2,0.6666666666666666,1,0.3333333333333333
-86.1515,39.771,1993,0,0.0,1785,0.8956347215253387,1785,0.8956347215253387,208,0.10436527847466132,72,0,0.0,63,0.875,63,0.875,9,0.125
-86.1515,39.7725,43,0,0.0,43,1.0,43,1.0,0,0.0,1,0,0.0,1,1.0,1,1.0,0,0.0
-86.1515,39.7735,4557,0,0.0,4075,0.8942286592056178,4075,0.8942286592056178,482,0.10577134079438227,31,0,0.0,28,0.9032258064516129,28,0.9032258064516129,3,0.0967741935483871
-86.1515,39.774,358,0,0.0,358,1.0,358,1.0,0,0.0,2,0,0.0,2,1.0,2,1.0,0,0.0
-86.1515,39.775,36,0,0.0,36,1.0,36,1.0,0,0.0,1,0,0.0,1,1.0,1,1.0,0,0.0
-86.1515,39.7775,30,0,0.0,30,1.0,30,1.0,0,0.0,1,0,0.0,1,1.0,1,1.0,0,0.0
-86.151,39.7665,191,0,0.0,114,0.5968586387434555,114,0.5968586387434555,77,0.4031413612565445,4,0,0.0,3,0.75,3,0.75,1,0.25
-86.151,39.768,46,0,0.0,46,1.0,46,1.0,0,0.0,1,0,0.0,1,1.0,1,1.0,0,0.0
-86.151,39.7695,544,0,0.0,484,0.8897058823529411,484,0.8897058823529411,60,0.11029411764705882,3,0,0.0,2,0.6666666666666666,2,0.6666666666666666,1,0.3333333333333333
-86.151,39.77,5,0,0.0,0,0.0,0,0.0,5,1.0,1,0,0.0,0,0.0,0,0.0,1,1.0
-86.151,39.771,2292,0,0.0,2130,0.9293193717277487,2130,0.9293193717277487,162,0.07068062827225131,35,0,0.0,29,0.8285714285714286,29,0.8285714285714286,6,0.17142857142857143
-86.151,39.7725,40,0,0.0,40,1.0,40,1.0,0,0.0,1,0,0.0,1,1.0,1,1.0,0,0.0
-86.151,39.7735,4896,0,0.0,4719,0.9638480392156863,4719,0.9638480392156863,177,0.03615196078431373,28,0,0.0,25,0.8928571428571429,25,0.8928571428571429,3,0.10714285714285714
-86.151,39.774,130,0,0.0,130,1.0,130,1.0,0,0.0,4,0,0.0,4,1.0,4,1.0,0,0.0
-86.151,39.775,34,0,0.0,34,1.0,34,1.0,0,0.0,2,0,0.0,2,1.0,2,1.0,0,0.0
-86.151,39.7775,29,0,0.0,29,1.0,29,1.0,0,0.0,1,0,0.0,1,1.0,1,1.0,0,0.0
-86.1505,39.7665,740,0,0.0,677,0.9148648648648648,677,0.9148648648648648,63,0.08513513513513514,9,0,0.0,6,0.6666666666666666,6,0.6666666666666666,3,0.3333333333333333
-86.1505,39.767,552,0,0.0,67,0.1213768115942029,67,0.1213768115942029,485,0.8786231884057971,3,0,0.0,1,0.3333333333333333,1,0.3333333333333333,2,0.6666666666666666
-86.1505,39.7675,69,0,0.0,0,0.0,0,0.0,69,1.0,1,0,0.0,0,0.0,0,0.0,1,1.0
-86.1505,39.768,79,0,0.0,44,0.5569620253164557,44,0.5569620253164557,35,0.4430379746835443,2,0,0.0,1,0.5,1,0.5,1,0.5
-86.1505,39.7695,625,0,0.0,625,1.0,625,1.0,0,0.0,2,0,0.0,2,1.0,2,1.0,0,0.0
-86.1505,39.77,142,0,0.0,77,0.5422535211267606,77,0.5422535211267606,65,0.45774647887323944,2,0,0.0,1,0.5,1,0.5,1,0.5
-86.1505,39.7705,213,0,0.0,92,0.431924882629108,92,0.431924882629108,121,0.568075117370892,4,0,0.0,2,0.5,2,0.5,2,0.5
-86.1505,39.771,14050,0,0.0,12108,0.861779359430605,12108,0.861779359430605,1942,0.138220640569395,20,0,0.0,16,0.8,16,0.8,4,0.2
-86.1505,39.7715,2497,0,0.0,2031,0.8133760512615138,2031,0.8133760512615138,466,0.18662394873848617,17,0,0.0,13,0.7647058823529411,13,0.7647058823529411,4,0.23529411764705882
-86.1505,39.772,2939,0,0.0,2520,0.857434501531133,2520,0.857434501531133,419,0.14256549846886696,16,0,0.0,12,0.75,12,0.75,4,0.25
-86.1505,39.7725,2739,0,0.0,2492,0.909821102592187,2492,0.909821102592187,247,0.09017889740781307,88,0,0.0,83,0.9431818181818182,83,0.9431818181818182,5,0.056818181818181816
-86.1505,39.773,4067,0,0.0,3662,0.900417998524711,3662,0.900417998524711,405,0.09958200147528891,28,0,0.0,24,0.8571428571428571,24,0.8571428571428571,4,0.14285714285714285
-86.1505,39.7735,11448,0,0.0,10219,0.8926450034940601,10219,0.8926450034940601,1229,0.1073549965059399,31,0,0.0,28,0.9032258064516129,28,0.9032258064516129,3,0.0967741935483871
-86.1505,39.774,907,0,0.0,907,1.0,907,1.0,0,0.0,3,0,0.0,3,1.0,3,1.0,0,0.0
-86.1505,39.7745,194,0,0.0,194,1.0,194,1.0,0,0.0,3,0,0.0,3,1.0,3,1.0,0,0.0
-86.1505,39.775,173,0,0.0,173,1.0,173,1.0,0,0.0,4,0,0.0,4,1.0,4,1.0,0,0.0
-86.1505,39.7755,108,0,0.0,108,1.0,108,1.0,0,0.0,4,0,0.0,4,1.0,4,1.0,0,0.0
-86.1505,39.776,82,0,0.0,82,1.0,82,1.0,0,0.0,1,0,0.0,1,1.0,1,1.0,0,0.0
-86.1505,39.7765,30,0,0.0,30,1.0,30,1.0,0,0.0,1,0,0.0,1,1.0,1,1.0,0,0.0
-86.1505,39.7775,29,0,0.0,29,1.0,29,1.0,0,0.0,1,0,0.0,1,1.0,1,1.0,0,0.0
