grid_lat,grid_lon,total_sample,mw_sample,mw_ratio,sub6_sample,sub6_ratio,5g_sample,5g_sample,lte_sample,lte_ratio,total_cs_sample,mw_cs_sample,mw_cs_ratio,sub6_cs_sample,sub6_cs_ratio,5g_cs_sample,5g_cs_sample,lte_cs_sample,lte_cs_ratio
-87.632,41.889,258,0,0.0,258,1.0,258,1.0,0,0.0,2,0,0.0,2,1.0,2,1.0,0,0.0
-87.632,41.8895,314,0,0.0,299,0.9522292993630573,299,0.9522292993630573,15,0.04777070063694268,8,0,0.0,6,0.75,6,0.75,2,0.25
-87.632,41.89,100,0,0.0,100,1.0,100,1.0,0,0.0,4,0,0.0,4,1.0,4,1.0,0,0.0
-87.632,41.891,176,0,0.0,171,0.9715909090909091,171,0.9715909090909091,5,0.028409090909090908,4,0,0.0,3,0.75,3,0.75,1,0.25
-87.632,41.8915,1782,0,0.0,1236,0.6936026936026936,1236,0.6936026936026936,546,0.3063973063973064,3,0,0.0,2,0.6666666666666666,2,0.6666666666666666,1,0.3333333333333333
-87.632,41.892,1408,0,0.0,701,0.4978693181818182,701,0.4978693181818182,707,0.5021306818181818,15,0,0.0,3,0.2,3,0.2,12,0.8
-87.632,41.893,1004,0,0.0,1004,1.0,1004,1.0,0,0.0,1,0,0.0,1,1.0,1,1.0,0,0.0
-87.632,41.8935,15,0,0.0,15,1.0,15,1.0,0,0.0,1,0,0.0,1,1.0,1,1.0,0,0.0
-87.632,41.894,41,0,0.0,41,1.0,41,1.0,0,0.0,1,0,0.0,1,1.0,1,1.0,0,0.0
-87.632,41.8945,356,0,0.0,347,0.9747191011235955,347,0.9747191011235955,9,0.025280898876404494,6,0,0.0,4,0.6666666666666666,4,0.6666666666666666,2,0.3333333333333333
-87.632,41.8955,162,0,0.0,162,1.0,162,1.0,0,0.0,3,0,0.0,3,1.0,3,1.0,0,0.0
-87.632,41.8965,54,0,0.0,54,1.0,54,1.0,0,0.0,1,0,0.0,1,1.0,1,1.0,0,0.0
-87.632,41.899,15,0,0.0,11,0.7333333333333333,11,0.7333333333333333,4,0.26666666666666666,3,0,0.0,2,0.6666666666666666,2,0.6666666666666666,1,0.3333333333333333
-87.6315,41.889,79,0,0.0,74,0.9367088607594937,74,0.9367088607594937,5,0.06329113924050633,3,0,0.0,2,0.6666666666666666,2,0.6666666666666666,1,0.3333333333333333
-87.6315,41.8895,284,0,0.0,273,0.9612676056338029,273,0.9612676056338029,11,0.03873239436619718,5,0,0.0,4,0.8,4,0.8,1,0.2
-87.6315,41.89,27,0,0.0,27,1.0,27,1.0,0,0.0,2,0,0.0,2,1.0,2,1.0,0,0.0
-87.6315,41.8915,1200,0,0.0,997,0.8308333333333333,997,0.8308333333333333,203,0.16916666666666666,13,0,0.0,8,0.6153846153846154,8,0.6153846153846154,5,0.38461538461538464
-87.6315,41.892,1298,0,0.0,704,0.5423728813559322,704,0.5423728813559322,594,0.4576271186440678,15,0,0.0,12,0.8,12,0.8,3,0.2
-87.6315,41.893,453,0,0.0,453,1.0,453,1.0,0,0.0,1,0,0.0,1,1.0,1,1.0,0,0.0
-87.6315,41.894,380,0,0.0,380,1.0,380,1.0,0,0.0,1,0,0.0,1,1.0,1,1.0,0,0.0
-87.6315,41.8945,108,0,0.0,108,1.0,108,1.0,0,0.0,1,0,0.0,1,1.0,1,1.0,0,0.0
-87.6315,41.8955,173,0,0.0,149,0.861271676300578,149,0.861271676300578,24,0.13872832369942195,11,0,0.0,8,0.7272727272727273,8,0.7272727272727273,3,0.2727272727272727
-87.6315,41.8965,38,0,0.0,33,0.868421052631579,33,0.868421052631579,5,0.13157894736842105,4,0,0.0,3,0.75,3,0.75,1,0.25
-87.6315,41.899,38,0,0.0,38,1.0,38,1.0,0,0.0,1,0,0.0,1,1.0,1,1.0,0,0.0
-87.631,41.889,60,0,0.0,54,0.9,54,0.9,6,0.1,4,0,0.0,2,0.5,2,0.5,2,0.5
-87.631,41.8895,398,0,0.0,394,0.9899497487437185,394,0.9899497487437185,4,0.010050251256281407,6,0,0.0,5,0.8333333333333334,5,0.8333333333333334,1,0.16666666666666666
-87.631,41.89,62,0,0.0,57,0.9193548387096774,57,0.9193548387096774,5,0.08064516129032258,3,0,0.0,2,0.6666666666666666,2,0.6666666666666666,1,0.3333333333333333
-87.631,41.8915,578,0,0.0,323,0.5588235294117647,323,0.5588235294117647,255,0.4411764705882353,40,0,0.0,17,0.425,17,0.425,23,0.575
-87.631,41.892,3118,0,0.0,1591,0.5102629890955741,1591,0.5102629890955741,1527,0.4897370109044259,8,0,0.0,5,0.625,5,0.625,3,0.375
-87.631,41.8925,396,0,0.0,391,0.9873737373737373,391,0.9873737373737373,5,0.012626262626262626,4,0,0.0,3,0.75,3,0.75,1,0.25
-87.631,41.893,704,0,0.0,690,0.9801136363636364,690,0.9801136363636364,14,0.019886363636363636,8,0,0.0,6,0.75,6,0.75,2,0.25
-87.631,41.8935,214,0,0.0,189,0.883177570093458,189,0.883177570093458,25,0.11682242990654206,13,0,0.0,9,0.6923076923076923,9,0.6923076923076923,4,0.3076923076923077
-87.631,41.894,182,0,0.0,168,0.9230769230769231,168,0.9230769230769231,14,0.07692307692307693,9,0,0.0,6,0.6666666666666666,6,0.6666666666666666,3,0.3333333333333333
-87.631,41.8945,294,0,0.0,262,0.891156462585034,262,0.891156462585034,32,0.10884353741496598,12,0,0.0,8,0.6666666666666666,8,0.6666666666666666,4,0.3333333333333333
-87.631,41.895,253,0,0.0,253,1.0,253,1.0,0,0.0,1,0,0.0,1,1.0,1,1.0,0,0.0
-87.631,41.8955,1594,0,0.0,1593,0.9993726474278545,1593,0.9993726474278545,1,0.0006273525721455458,3,0,0.0,2,0.6666666666666666,2,0.6666666666666666,1,0.3333333333333333
-87.631,41.896,209,0,0.0,176,0.8421052631578947,176,0.8421052631578947,33,0.15789473684210525,13,0,0.0,8,0.6153846153846154,8,0.6153846153846154,5,0.38461538461538464
-87.631,41.8965,250,0,0.0,250,1.0,250,1.0,0,0.0,7,0,0.0,7,1.0,7,1.0,0,0.0
-87.631,41.897,279,0,0.0,279,1.0,279,1.0,0,0.0,1,0,0.0,1,1.0,1,1.0,0,0.0
-87.631,41.898,405,0,0.0,405,1.0,405,1.0,0,0.0,1,0,0.0,1,1.0,1,1.0,0,0.0
-87.631,41.8985,130,0,0.0,130,1.0,130,1.0,0,0.0,1,0,0.0,1,1.0,1,1.0,0,0.0
-87.631,41.899,182,0,0.0,173,0.9505494505494505,173,0.9505494505494505,9,0.04945054945054945,6,0,0.0,4,0.6666666666666666,4,0.6666666666666666,2,0.3333333333333333
-87.631,41.8995,370,0,0.0,359,0.9702702702702702,359,0.9702702702702702,11,0.02972972972972973,11,0,0.0,9,0.8181818181818182,9,0.8181818181818182,2,0.18181818181818182
-87.631,41.9,137,0,0.0,126,0.9197080291970803,126,0.9197080291970803,11,0.08029197080291971,5,0,0.0,3,0.6,3,0.6,2,0.4
-87.6305,41.889,82,0,0.0,76,0.926829268292683,76,0.926829268292683,6,0.07317073170731707,2,0,0.0,1,0.5,1,0.5,1,0.5
-87.6305,41.8895,127,0,0.0,108,0.8503937007874016,108,0.8503937007874016,19,0.14960629921259844,7,0,0.0,5,0.7142857142857143,5,0.7142857142857143,2,0.2857142857142857
-87.6305,41.89,395,0,0.0,386,0.9772151898734177,386,0.9772151898734177,9,0.02278481012658228,4,0,0.0,3,0.75,3,0.75,1,0.25
-87.6305,41.8915,458,0,0.0,208,0.45414847161572053,208,0.45414847161572053,250,0.5458515283842795,12,0,0.0,9,0.75,9,0.75,3,0.25
-87.6305,41.892,1852,0,0.0,1514,0.8174946004319654,1514,0.8174946004319654,338,0.18250539956803455,6,0,0.0,3,0.5,3,0.5,3,0.5
-87.6305,41.8925,340,0,0.0,301,0.8852941176470588,301,0.8852941176470588,39,0.11470588235294117,5,0,0.0,3,0.6,3,0.6,2,0.4
-87.6305,41.893,576,0,0.0,576,1.0,576,1.0,0,0.0,1,0,0.0,1,1.0,1,1.0,0,0.0
-87.6305,41.8935,183,0,0.0,183,1.0,183,1.0,0,0.0,3,0,0.0,3,1.0,3,1.0,0,0.0
-87.6305,41.894,39,0,0.0,34,0.8717948717948718,34,0.8717948717948718,5,0.1282051282051282,4,0,0.0,3,0.75,3,0.75,1,0.25
-87.6305,41.8945,58,0,0.0,58,1.0,58,1.0,0,0.0,1,0,0.0,1,1.0,1,1.0,0,0.0
-87.6305,41.8955,88,0,0.0,88,1.0,88,1.0,0,0.0,1,0,0.0,1,1.0,1,1.0,0,0.0
-87.6305,41.8965,635,0,0.0,625,0.984251968503937,625,0.984251968503937,10,0.015748031496062992,6,0,0.0,4,0.6666666666666666,4,0.6666666666666666,2,0.3333333333333333
-87.6305,41.8995,117,0,0.0,117,1.0,117,1.0,0,0.0,1,0,0.0,1,1.0,1,1.0,0,0.0
-87.63,41.889,59,0,0.0,59,1.0,59,1.0,0,0.0,1,0,0.0,1,1.0,1,1.0,0,0.0
-87.63,41.8895,69,0,0.0,65,0.9420289855072463,65,0.9420289855072463,4,0.057971014492753624,3,0,0.0,2,0.6666666666666666,2,0.6666666666666666,1,0.3333333333333333
-87.63,41.89,172,0,0.0,167,0.9709302325581395,167,0.9709302325581395,5,0.029069767441860465,4,0,0.0,3,0.75,3,0.75,1,0.25
-87.63,41.8915,405,0,0.0,212,0.5234567901234568,212,0.5234567901234568,193,0.4765432098765432,19,0,0.0,9,0.47368421052631576,9,0.47368421052631576,10,0.5263157894736842
-87.63,41.892,3044,0,0.0,2130,0.6997371879106439,2130,0.6997371879106439,914,0.3002628120893561,41,0,0.0,17,0.4146341463414634,17,0.4146341463414634,24,0.5853658536585366
-87.63,41.8925,564,0,0.0,343,0.6081560283687943,343,0.6081560283687943,221,0.39184397163120566,7,0,0.0,4,0.5714285714285714,4,0.5714285714285714,3,0.42857142857142855
-87.63,41.893,334,0,0.0,327,0.9790419161676647,327,0.9790419161676647,7,0.020958083832335328,3,0,0.0,2,0.6666666666666666,2,0.6666666666666666,1,0.3333333333333333
-87.63,41.894,86,0,0.0,86,1.0,86,1.0,0,0.0,2,0,0.0,2,1.0,2,1.0,0,0.0
-87.63,41.8945,52,0,0.0,44,0.8461538461538461,44,0.8461538461538461,8,0.15384615384615385,3,0,0.0,2,0.6666666666666666,2,0.6666666666666666,1,0.3333333333333333
-87.63,41.8955,245,0,0.0,241,0.9836734693877551,241,0.9836734693877551,4,0.0163265306122449,4,0,0.0,3,0.75,3,0.75,1,0.25
-87.63,41.8965,108,0,0.0,102,0.9444444444444444,102,0.9444444444444444,6,0.05555555555555555,3,0,0.0,2,0.6666666666666666,2,0.6666666666666666,1,0.3333333333333333
-87.63,41.898,25,0,0.0,0,0.0,0,0.0,25,1.0,2,0,0.0,0,0.0,0,0.0,2,1.0
-87.63,41.8985,46,0,0.0,0,0.0,0,0.0,46,1.0,1,0,0.0,0,0.0,0,0.0,1,1.0
-87.63,41.899,57,0,0.0,0,0.0,0,0.0,57,1.0,2,0,0.0,0,0.0,0,0.0,2,1.0
-87.63,41.8995,160,0,0.0,51,0.31875,51,0.31875,109,0.68125,2,0,0.0,1,0.5,1,0.5,1,0.5
-87.63,41.9,42,0,0.0,0,0.0,0,0.0,42,1.0,2,0,0.0,0,0.0,0,0.0,2,1.0
-87.6295,41.889,139,0,0.0,139,1.0,139,1.0,0,0.0,4,0,0.0,4,1.0,4,1.0,0,0.0
-87.6295,41.8895,141,0,0.0,134,0.950354609929078,134,0.950354609929078,7,0.04964539007092199,5,0,0.0,3,0.6,3,0.6,2,0.4
-87.6295,41.89,208,0,0.0,194,0.9326923076923077,194,0.9326923076923077,14,0.0673076923076923,8,0,0.0,5,0.625,5,0.625,3,0.375
-87.6295,41.891,154,0,0.0,139,0.9025974025974026,139,0.9025974025974026,15,0.09740259740259741,8,0,0.0,5,0.625,5,0.625,3,0.375
-87.6295,41.8915,817,0,0.0,522,0.6389228886168911,522,0.6389228886168911,295,0.36107711138310894,26,0,0.0,17,0.6538461538461539,17,0.6538461538461539,9,0.34615384615384615
-87.6295,41.892,3089,0,0.0,1946,0.6299773389446423,1946,0.6299773389446423,1143,0.3700226610553577,23,0,0.0,12,0.5217391304347826,12,0.5217391304347826,11,0.4782608695652174
-87.6295,41.8925,1141,0,0.0,872,0.7642418930762489,872,0.7642418930762489,269,0.2357581069237511,31,0,0.0,17,0.5483870967741935,17,0.5483870967741935,14,0.45161290322580644
-87.6295,41.893,2781,0,0.0,2032,0.7306724199928083,2032,0.7306724199928083,749,0.26932758000719165,15,0,0.0,7,0.4666666666666667,7,0.4666666666666667,8,0.5333333333333333
-87.6295,41.8935,1477,0,0.0,470,0.3182125930941097,470,0.3182125930941097,1007,0.6817874069058903,7,0,0.0,4,0.5714285714285714,4,0.5714285714285714,3,0.42857142857142855
-87.6295,41.894,859,0,0.0,486,0.5657741559953434,486,0.5657741559953434,373,0.4342258440046566,40,0,0.0,17,0.425,17,0.425,23,0.575
-87.6295,41.8945,818,0,0.0,636,0.7775061124694377,636,0.7775061124694377,182,0.22249388753056235,20,0,0.0,12,0.6,12,0.6,8,0.4
-87.6295,41.895,611,0,0.0,473,0.7741407528641571,473,0.7741407528641571,138,0.22585924713584288,3,0,0.0,1,0.3333333333333333,1,0.3333333333333333,2,0.6666666666666666
-87.6295,41.8955,2034,0,0.0,1862,0.9154375614552606,1862,0.9154375614552606,172,0.08456243854473942,9,0,0.0,5,0.5555555555555556,5,0.5555555555555556,4,0.4444444444444444
-87.6295,41.896,4495,0,0.0,3742,0.832480533926585,3742,0.832480533926585,753,0.16751946607341492,18,0,0.0,11,0.6111111111111112,11,0.6111111111111112,7,0.3888888888888889
-87.6295,41.8965,1237,0,0.0,967,0.7817299919159256,967,0.7817299919159256,270,0.21827000808407437,43,0,0.0,23,0.5348837209302325,23,0.5348837209302325,20,0.46511627906976744
-87.6295,41.897,709,0,0.0,530,0.7475317348377997,530,0.7475317348377997,179,0.2524682651622003,25,0,0.0,12,0.48,12,0.48,13,0.52
-87.6295,41.898,831,0,0.0,661,0.7954271961492179,661,0.7954271961492179,170,0.2045728038507822,15,0,0.0,11,0.7333333333333333,11,0.7333333333333333,4,0.26666666666666666
-87.6295,41.8985,1301,0,0.0,1056,0.8116833205226749,1056,0.8116833205226749,245,0.18831667947732514,29,0,0.0,17,0.5862068965517241,17,0.5862068965517241,12,0.41379310344827586
-87.6295,41.899,693,0,0.0,575,0.8297258297258298,575,0.8297258297258298,118,0.17027417027417027,11,0,0.0,6,0.5454545454545454,6,0.5454545454545454,5,0.45454545454545453
-87.6295,41.8995,1559,0,0.0,1286,0.8248877485567672,1286,0.8248877485567672,273,0.17511225144323284,31,0,0.0,16,0.5161290322580645,16,0.5161290322580645,15,0.4838709677419355
-87.6295,41.9,2501,0,0.0,1464,0.5853658536585366,1464,0.5853658536585366,1037,0.4146341463414634,21,0,0.0,11,0.5238095238095238,11,0.5238095238095238,10,0.47619047619047616
-87.629,41.889,65,0,0.0,65,1.0,65,1.0,0,0.0,1,0,0.0,1,1.0,1,1.0,0,0.0
-87.629,41.8895,37,0,0.0,37,1.0,37,1.0,0,0.0,1,0,0.0,1,1.0,1,1.0,0,0.0
-87.629,41.89,359,0,0.0,359,1.0,359,1.0,0,0.0,2,0,0.0,2,1.0,2,1.0,0,0.0
-87.629,41.8915,2414,0,0.0,1747,0.723695111847556,1747,0.723695111847556,667,0.2763048881524441,9,0,0.0,7,0.7777777777777778,7,0.7777777777777778,2,0.2222222222222222
-87.629,41.892,424,0,0.0,146,0.3443396226415094,146,0.3443396226415094,278,0.6556603773584906,11,0,0.0,3,0.2727272727272727,3,0.2727272727272727,8,0.7272727272727273
-87.629,41.893,973,0,0.0,0,0.0,0,0.0,973,1.0,14,0,0.0,0,0.0,0,0.0,14,1.0
-87.629,41.894,300,0,0.0,0,0.0,0,0.0,300,1.0,12,0,0.0,0,0.0,0,0.0,12,1.0
-87.629,41.8965,34,0,0.0,30,0.8823529411764706,30,0.8823529411764706,4,0.11764705882352941,2,0,0.0,1,0.5,1,0.5,1,0.5
-87.6285,41.889,63,0,0.0,58,0.9206349206349206,58,0.9206349206349206,5,0.07936507936507936,4,0,0.0,3,0.75,3,0.75,1,0.25
-87.6285,41.89,245,0,0.0,241,0.9836734693877551,241,0.9836734693877551,4,0.0163265306122449,5,0,0.0,4,0.8,4,0.8,1,0.2
-87.6285,41.8915,503,0,0.0,294,0.584493041749503,294,0.584493041749503,209,0.415506958250497,8,0,0.0,6,0.75,6,0.75,2,0.25
-87.6285,41.892,637,0,0.0,348,0.5463108320251178,348,0.5463108320251178,289,0.45368916797488223,13,0,0.0,4,0.3076923076923077,4,0.3076923076923077,9,0.6923076923076923
-87.6285,41.8925,6,0,0.0,6,1.0,6,1.0,0,0.0,1,0,0.0,1,1.0,1,1.0,0,0.0
-87.6285,41.893,271,0,0.0,0,0.0,0,0.0,271,1.0,2,0,0.0,0,0.0,0,0.0,2,1.0
-87.6285,41.894,254,0,0.0,0,0.0,0,0.0,254,1.0,1,0,0.0,0,0.0,0,0.0,1,1.0
-87.6285,41.8965,53,0,0.0,53,1.0,53,1.0,0,0.0,1,0,0.0,1,1.0,1,1.0,0,0.0
-87.628,41.889,572,0,0.0,566,0.9895104895104895,566,0.9895104895104895,6,0.01048951048951049,5,0,0.0,4,0.8,4,0.8,1,0.2
-87.628,41.8895,111,0,0.0,111,1.0,111,1.0,0,0.0,2,0,0.0,2,1.0,2,1.0,0,0.0
-87.628,41.89,1035,0,0.0,1021,0.9864734299516909,1021,0.9864734299516909,14,0.01352657004830918,10,0,0.0,7,0.7,7,0.7,3,0.3
-87.628,41.891,143,0,0.0,143,1.0,143,1.0,0,0.0,2,0,0.0,2,1.0,2,1.0,0,0.0
-87.628,41.8915,1178,0,0.0,710,0.6027164685908319,710,0.6027164685908319,468,0.39728353140916806,20,0,0.0,10,0.5,10,0.5,10,0.5
-87.628,41.892,1263,0,0.0,721,0.5708630245447348,721,0.5708630245447348,542,0.42913697545526525,20,0,0.0,7,0.35,7,0.35,13,0.65
-87.628,41.8925,633,0,0.0,511,0.8072669826224329,511,0.8072669826224329,122,0.19273301737756715,8,0,0.0,4,0.5,4,0.5,4,0.5
-87.628,41.893,483,0,0.0,71,0.14699792960662525,71,0.14699792960662525,412,0.8530020703933747,7,0,0.0,1,0.14285714285714285,1,0.14285714285714285,6,0.8571428571428571
-87.628,41.8935,154,0,0.0,0,0.0,0,0.0,154,1.0,3,0,0.0,0,0.0,0,0.0,3,1.0
-87.628,41.894,1980,0,0.0,457,0.2308080808080808,457,0.2308080808080808,1523,0.7691919191919192,4,0,0.0,2,0.5,2,0.5,2,0.5
-87.628,41.8945,270,0,0.0,137,0.5074074074074074,137,0.5074074074074074,133,0.4925925925925926,3,0,0.0,2,0.6666666666666666,2,0.6666666666666666,1,0.3333333333333333
-87.628,41.895,141,0,0.0,141,1.0,141,1.0,0,0.0,1,0,0.0,1,1.0,1,1.0,0,0.0
-87.628,41.8955,78,0,0.0,70,0.8974358974358975,70,0.8974358974358975,8,0.10256410256410256,7,0,0.0,5,0.7142857142857143,5,0.7142857142857143,2,0.2857142857142857
-87.628,41.8965,494,0,0.0,144,0.291497975708502,144,0.291497975708502,350,0.708502024291498,4,0,0.0,2,0.5,2,0.5,2,0.5
-87.628,41.897,309,0,0.0,300,0.970873786407767,300,0.970873786407767,9,0.02912621359223301,8,0,0.0,6,0.75,6,0.75,2,0.25
-87.6275,41.8895,39,0,0.0,39,1.0,39,1.0,0,0.0,1,0,0.0,1,1.0,1,1.0,0,0.0
-87.6275,41.89,425,0,0.0,425,1.0,425,1.0,0,0.0,5,0,0.0,5,1.0,5,1.0,0,0.0
-87.6275,41.891,30,0,0.0,25,0.8333333333333334,25,0.8333333333333334,5,0.16666666666666666,3,0,0.0,2,0.6666666666666666,2,0.6666666666666666,1,0.3333333333333333
-87.6275,41.8915,1258,0,0.0,547,0.43481717011128773,547,0.43481717011128773,711,0.5651828298887123,5,0,0.0,4,0.8,4,0.8,1,0.2
-87.6275,41.892,238,0,0.0,108,0.453781512605042,108,0.453781512605042,130,0.5462184873949579,3,0,0.0,2,0.6666666666666666,2,0.6666666666666666,1,0.3333333333333333
-87.6275,41.8925,92,0,0.0,42,0.45652173913043476,42,0.45652173913043476,50,0.5434782608695652,2,0,0.0,1,0.5,1,0.5,1,0.5
-87.6275,41.893,613,0,0.0,53,0.0864600326264274,53,0.0864600326264274,560,0.9135399673735726,15,0,0.0,2,0.13333333333333333,2,0.13333333333333333,13,0.8666666666666667
-87.6275,41.894,313,0,0.0,55,0.1757188498402556,55,0.1757188498402556,258,0.8242811501597445,2,0,0.0,1,0.5,1,0.5,1,0.5
-87.6275,41.8945,631,0,0.0,214,0.33914421553090335,214,0.33914421553090335,417,0.6608557844690967,2,0,0.0,2,1.0,2,1.0,0,0.0
-87.6275,41.895,22,0,0.0,22,1.0,22,1.0,0,0.0,1,0,0.0,1,1.0,1,1.0,0,0.0
-87.6275,41.8955,404,0,0.0,404,1.0,404,1.0,0,0.0,2,0,0.0,2,1.0,2,1.0,0,0.0
-87.6275,41.8965,787,0,0.0,716,0.9097839898348158,716,0.9097839898348158,71,0.09021601016518424,4,0,0.0,3,0.75,3,0.75,1,0.25
-87.6275,41.897,94,0,0.0,92,0.9787234042553191,92,0.9787234042553191,2,0.02127659574468085,4,0,0.0,3,0.75,3,0.75,1,0.25
-87.627,41.89,129,0,0.0,119,0.9224806201550387,119,0.9224806201550387,10,0.07751937984496124,5,0,0.0,3,0.6,3,0.6,2,0.4
-87.627,41.891,27,0,0.0,27,1.0,27,1.0,0,0.0,1,0,0.0,1,1.0,1,1.0,0,0.0
-87.627,41.8915,245,0,0.0,154,0.6285714285714286,154,0.6285714285714286,91,0.37142857142857144,9,0,0.0,6,0.6666666666666666,6,0.6666666666666666,3,0.3333333333333333
-87.627,41.892,585,0,0.0,284,0.48547008547008547,284,0.48547008547008547,301,0.5145299145299145,10,0,0.0,2,0.2,2,0.2,8,0.8
-87.627,41.8925,336,0,0.0,38,0.1130952380952381,38,0.1130952380952381,298,0.8869047619047619,3,0,0.0,1,0.3333333333333333,1,0.3333333333333333,2,0.6666666666666666
-87.627,41.893,338,0,0.0,28,0.08284023668639054,28,0.08284023668639054,310,0.9171597633136095,4,0,0.0,1,0.25,1,0.25,3,0.75
-87.627,41.894,383,0,0.0,95,0.24804177545691905,95,0.24804177545691905,288,0.7519582245430809,13,0,0.0,2,0.15384615384615385,2,0.15384615384615385,11,0.8461538461538461
-87.627,41.8945,142,0,0.0,115,0.8098591549295775,115,0.8098591549295775,27,0.19014084507042253,9,0,0.0,6,0.6666666666666666,6,0.6666666666666666,3,0.3333333333333333
-87.627,41.895,18,0,0.0,18,1.0,18,1.0,0,0.0,1,0,0.0,1,1.0,1,1.0,0,0.0
-87.627,41.8955,150,0,0.0,136,0.9066666666666666,136,0.9066666666666666,14,0.09333333333333334,9,0,0.0,6,0.6666666666666666,6,0.6666666666666666,3,0.3333333333333333
-87.627,41.8965,2653,0,0.0,2580,0.9724839803995476,2580,0.9724839803995476,73,0.02751601960045232,21,0,0.0,15,0.7142857142857143,15,0.7142857142857143,6,0.2857142857142857
-87.627,41.897,818,0,0.0,818,1.0,818,1.0,0,0.0,1,0,0.0,1,1.0,1,1.0,0,0.0
-87.6265,41.8895,302,0,0.0,293,0.9701986754966887,293,0.9701986754966887,9,0.029801324503311258,6,0,0.0,4,0.6666666666666666,4,0.6666666666666666,2,0.3333333333333333
-87.6265,41.89,296,0,0.0,277,0.9358108108108109,277,0.9358108108108109,19,0.06418918918918919,12,0,0.0,8,0.6666666666666666,8,0.6666666666666666,4,0.3333333333333333
-87.6265,41.891,165,0,0.0,165,1.0,165,1.0,0,0.0,3,0,0.0,3,1.0,3,1.0,0,0.0
-87.6265,41.8915,2356,0,0.0,2131,0.9044991511035654,2131,0.9044991511035654,225,0.09550084889643463,38,0,0.0,24,0.631578947368421,24,0.631578947368421,14,0.3684210526315789
-87.6265,41.892,2274,0,0.0,1908,0.8390501319261213,1908,0.8390501319261213,366,0.16094986807387862,38,0,0.0,21,0.5526315789473685,21,0.5526315789473685,17,0.4473684210526316
-87.6265,41.8925,551,0,0.0,149,0.27041742286751363,149,0.27041742286751363,402,0.7295825771324864,11,0,0.0,5,0.45454545454545453,5,0.45454545454545453,6,0.5454545454545454
-87.6265,41.893,2067,0,0.0,1587,0.7677793904208998,1587,0.7677793904208998,480,0.23222060957910015,40,0,0.0,22,0.55,22,0.55,18,0.45
-87.6265,41.8935,1290,0,0.0,900,0.6976744186046512,900,0.6976744186046512,390,0.3023255813953488,30,0,0.0,13,0.43333333333333335,13,0.43333333333333335,17,0.5666666666666667
-87.6265,41.894,1146,0,0.0,818,0.7137870855148342,818,0.7137870855148342,328,0.2862129144851658,21,0,0.0,14,0.6666666666666666,14,0.6666666666666666,7,0.3333333333333333
-87.6265,41.8945,1306,0,0.0,972,0.7442572741194488,972,0.7442572741194488,334,0.2557427258805513,32,0,0.0,17,0.53125,17,0.53125,15,0.46875
-87.6265,41.895,553,0,0.0,356,0.64376130198915,356,0.64376130198915,197,0.3562386980108499,7,0,0.0,5,0.7142857142857143,5,0.7142857142857143,2,0.2857142857142857
-87.6265,41.8955,1398,0,0.0,1093,0.7818311874105865,1093,0.7818311874105865,305,0.21816881258941345,44,0,0.0,23,0.5227272727272727,23,0.5227272727272727,21,0.4772727272727273
-87.6265,41.896,187,0,0.0,165,0.8823529411764706,165,0.8823529411764706,22,0.11764705882352941,10,0,0.0,5,0.5,5,0.5,5,0.5
-87.6265,41.8965,3828,0,0.0,3691,0.9642110762800418,3691,0.9642110762800418,137,0.035788923719958204,52,0,0.0,39,0.75,39,0.75,13,0.25
-87.6265,41.897,185,0,0.0,175,0.9459459459459459,175,0.9459459459459459,10,0.05405405405405406,7,0,0.0,5,0.7142857142857143,5,0.7142857142857143,2,0.2857142857142857
-87.626,41.891,37,0,0.0,37,1.0,37,1.0,0,0.0,1,0,0.0,1,1.0,1,1.0,0,0.0
-87.626,41.8915,855,0,0.0,855,1.0,855,1.0,0,0.0,8,0,0.0,8,1.0,8,1.0,0,0.0
-87.626,41.892,555,0,0.0,551,0.9927927927927928,551,0.9927927927927928,4,0.007207207207207207,11,0,0.0,10,0.9090909090909091,10,0.9090909090909091,1,0.09090909090909091
-87.626,41.8925,704,0,0.0,495,0.703125,495,0.703125,209,0.296875,20,0,0.0,12,0.6,12,0.6,8,0.4
-87.626,41.893,871,0,0.0,762,0.8748564867967853,762,0.8748564867967853,109,0.1251435132032147,7,0,0.0,4,0.5714285714285714,4,0.5714285714285714,3,0.42857142857142855
-87.626,41.894,416,0,0.0,416,1.0,416,1.0,0,0.0,8,0,0.0,8,1.0,8,1.0,0,0.0
-87.626,41.8945,664,0,0.0,496,0.7469879518072289,496,0.7469879518072289,168,0.25301204819277107,28,0,0.0,15,0.5357142857142857,15,0.5357142857142857,13,0.4642857142857143
-87.626,41.8955,670,0,0.0,468,0.6985074626865672,468,0.6985074626865672,202,0.30149253731343284,39,0,0.0,23,0.5897435897435898,23,0.5897435897435898,16,0.41025641025641024
-87.626,41.896,407,0,0.0,407,1.0,407,1.0,0,0.0,4,0,0.0,4,1.0,4,1.0,0,0.0
-87.626,41.8965,2571,0,0.0,2104,0.8183586153247764,2104,0.8183586153247764,467,0.18164138467522364,43,0,0.0,30,0.6976744186046512,30,0.6976744186046512,13,0.3023255813953488
-87.6255,41.8915,515,0,0.0,515,1.0,515,1.0,0,0.0,10,0,0.0,10,1.0,10,1.0,0,0.0
-87.6255,41.892,259,0,0.0,249,0.9613899613899614,249,0.9613899613899614,10,0.03861003861003861,13,0,0.0,10,0.7692307692307693,10,0.7692307692307693,3,0.23076923076923078
-87.6255,41.8925,1974,0,0.0,1568,0.7943262411347518,1568,0.7943262411347518,406,0.20567375886524822,20,0,0.0,11,0.55,11,0.55,9,0.45
-87.6255,41.893,533,0,0.0,429,0.8048780487804879,429,0.8048780487804879,104,0.1951219512195122,6,0,0.0,4,0.6666666666666666,4,0.6666666666666666,2,0.3333333333333333
-87.6255,41.894,853,0,0.0,780,0.9144196951934349,780,0.9144196951934349,73,0.08558030480656506,28,0,0.0,19,0.6785714285714286,19,0.6785714285714286,9,0.32142857142857145
-87.6255,41.8945,529,0,0.0,360,0.6805293005671077,360,0.6805293005671077,169,0.31947069943289225,27,0,0.0,15,0.5555555555555556,15,0.5555555555555556,12,0.4444444444444444
-87.6255,41.895,19,0,0.0,11,0.5789473684210527,11,0.5789473684210527,8,0.42105263157894735,4,0,0.0,2,0.5,2,0.5,2,0.5
-87.6255,41.8955,2014,0,0.0,1637,0.8128103277060575,1637,0.8128103277060575,377,0.1871896722939424,34,0,0.0,18,0.5294117647058824,18,0.5294117647058824,16,0.47058823529411764
-87.6255,41.896,54,0,0.0,50,0.9259259259259259,50,0.9259259259259259,4,0.07407407407407407,3,0,0.0,2,0.6666666666666666,2,0.6666666666666666,1,0.3333333333333333
-87.6255,41.8965,2857,0,0.0,2804,0.9814490724536227,2804,0.9814490724536227,53,0.01855092754637732,23,0,0.0,15,0.6521739130434783,15,0.6521739130434783,8,0.34782608695652173
-87.6255,41.897,7,0,0.0,0,0.0,0,0.0,7,1.0,1,0,0.0,0,0.0,0,0.0,1,1.0
-87.625,41.8915,745,0,0.0,745,1.0,745,1.0,0,0.0,16,0,0.0,16,1.0,16,1.0,0,0.0
-87.625,41.892,175,0,0.0,167,0.9542857142857143,167,0.9542857142857143,8,0.045714285714285714,9,0,0.0,7,0.7777777777777778,7,0.7777777777777778,2,0.2222222222222222
-87.625,41.8925,723,0,0.0,504,0.6970954356846473,504,0.6970954356846473,219,0.3029045643153527,29,0,0.0,20,0.6896551724137931,20,0.6896551724137931,9,0.3103448275862069
-87.625,41.893,1125,0,0.0,654,0.5813333333333334,654,0.5813333333333334,471,0.4186666666666667,18,0,0.0,12,0.6666666666666666,12,0.6666666666666666,6,0.3333333333333333
-87.625,41.8935,32,0,0.0,32,1.0,32,1.0,0,0.0,1,0,0.0,1,1.0,1,1.0,0,0.0
-87.625,41.894,487,0,0.0,487,1.0,487,1.0,0,0.0,2,0,0.0,2,1.0,2,1.0,0,0.0
-87.625,41.8945,916,0,0.0,734,0.8013100436681223,734,0.8013100436681223,182,0.19868995633187772,20,0,0.0,12,0.6,12,0.6,8,0.4
-87.625,41.895,121,0,0.0,121,1.0,121,1.0,0,0.0,1,0,0.0,1,1.0,1,1.0,0,0.0
-87.625,41.8955,703,0,0.0,502,0.7140825035561877,502,0.7140825035561877,201,0.28591749644381226,13,0,0.0,10,0.7692307692307693,10,0.7692307692307693,3,0.23076923076923078
-87.625,41.896,58,0,0.0,51,0.8793103448275862,51,0.8793103448275862,7,0.1206896551724138,3,0,0.0,2,0.6666666666666666,2,0.6666666666666666,1,0.3333333333333333
-87.625,41.8965,1615,0,0.0,1545,0.9566563467492261,1545,0.9566563467492261,70,0.043343653250773995,36,0,0.0,23,0.6388888888888888,23,0.6388888888888888,13,0.3611111111111111
-87.625,41.897,1,0,0.0,1,1.0,1,1.0,0,0.0,1,0,0.0,1,1.0,1,1.0,0,0.0
-87.6245,41.8915,522,0,0.0,522,1.0,522,1.0,0,0.0,10,0,0.0,10,1.0,10,1.0,0,0.0
-87.6245,41.892,496,0,0.0,488,0.9838709677419355,488,0.9838709677419355,8,0.016129032258064516,10,0,0.0,8,0.8,8,0.8,2,0.2
-87.6245,41.8925,3228,0,0.0,2736,0.8475836431226765,2736,0.8475836431226765,492,0.1524163568773234,23,0,0.0,16,0.6956521739130435,16,0.6956521739130435,7,0.30434782608695654
-87.6245,41.893,488,0,0.0,359,0.735655737704918,359,0.735655737704918,129,0.26434426229508196,25,0,0.0,15,0.6,15,0.6,10,0.4
-87.6245,41.8935,37,0,0.0,37,1.0,37,1.0,0,0.0,1,0,0.0,1,1.0,1,1.0,0,0.0
-87.6245,41.894,2448,0,0.0,2325,0.9497549019607843,2325,0.9497549019607843,123,0.05024509803921569,10,0,0.0,8,0.8,8,0.8,2,0.2
-87.6245,41.8945,510,0,0.0,374,0.7333333333333333,374,0.7333333333333333,136,0.26666666666666666,28,0,0.0,15,0.5357142857142857,15,0.5357142857142857,13,0.4642857142857143
-87.6245,41.895,50,0,0.0,42,0.84,42,0.84,8,0.16,3,0,0.0,2,0.6666666666666666,2,0.6666666666666666,1,0.3333333333333333
-87.6245,41.8955,4718,0,0.0,3709,0.7861381941500636,3709,0.7861381941500636,1009,0.21386180584993641,37,0,0.0,20,0.5405405405405406,20,0.5405405405405406,17,0.4594594594594595
-87.6245,41.8965,2479,0,0.0,2422,0.9770068576038725,2422,0.9770068576038725,57,0.022993142396127472,35,0,0.0,25,0.7142857142857143,25,0.7142857142857143,10,0.2857142857142857
-87.624,41.891,3233,0,0.0,3021,0.9344262295081968,3021,0.9344262295081968,212,0.06557377049180328,22,0,0.0,14,0.6363636363636364,14,0.6363636363636364,8,0.36363636363636365
-87.624,41.8915,1316,0,0.0,1279,0.9718844984802432,1279,0.9718844984802432,37,0.02811550151975684,27,0,0.0,20,0.7407407407407407,20,0.7407407407407407,7,0.25925925925925924
-87.624,41.892,693,0,0.0,667,0.9624819624819625,667,0.9624819624819625,26,0.03751803751803752,22,0,0.0,17,0.7727272727272727,17,0.7727272727272727,5,0.22727272727272727
-87.624,41.8925,4724,0,0.0,3452,0.7307366638441999,3452,0.7307366638441999,1272,0.26926333615580017,70,0,0.0,45,0.6428571428571429,45,0.6428571428571429,25,0.35714285714285715
-87.624,41.893,3116,0,0.0,2834,0.9094993581514762,2834,0.9094993581514762,282,0.09050064184852374,40,0,0.0,28,0.7,28,0.7,12,0.3
-87.624,41.8935,2483,0,0.0,2342,0.9432138542086186,2342,0.9432138542086186,141,0.056786145791381394,54,0,0.0,31,0.5740740740740741,31,0.5740740740740741,23,0.42592592592592593
-87.624,41.894,2769,0,0.0,2616,0.9447453954496208,2616,0.9447453954496208,153,0.0552546045503792,50,0,0.0,32,0.64,32,0.64,18,0.36
-87.624,41.8945,2691,0,0.0,1915,0.7116313638052768,1915,0.7116313638052768,776,0.28836863619472314,38,0,0.0,24,0.631578947368421,24,0.631578947368421,14,0.3684210526315789
-87.624,41.895,648,0,0.0,633,0.9768518518518519,633,0.9768518518518519,15,0.023148148148148147,11,0,0.0,8,0.7272727272727273,8,0.7272727272727273,3,0.2727272727272727
-87.624,41.8955,1995,0,0.0,1792,0.8982456140350877,1792,0.8982456140350877,203,0.10175438596491228,30,0,0.0,19,0.6333333333333333,19,0.6333333333333333,11,0.36666666666666664
-87.624,41.896,845,0,0.0,824,0.9751479289940829,824,0.9751479289940829,21,0.02485207100591716,15,0,0.0,10,0.6666666666666666,10,0.6666666666666666,5,0.3333333333333333
-87.624,41.8965,1597,0,0.0,1513,0.947401377582968,1513,0.947401377582968,84,0.052598622417031934,41,0,0.0,30,0.7317073170731707,30,0.7317073170731707,11,0.2682926829268293
-87.6235,41.891,160,0,0.0,159,0.99375,159,0.99375,1,0.00625,6,0,0.0,5,0.8333333333333334,5,0.8333333333333334,1,0.16666666666666666
-87.6235,41.8915,483,0,0.0,444,0.9192546583850931,444,0.9192546583850931,39,0.08074534161490683,28,0,0.0,20,0.7142857142857143,20,0.7142857142857143,8,0.2857142857142857
-87.6235,41.892,129,0,0.0,119,0.9224806201550387,119,0.9224806201550387,10,0.07751937984496124,6,0,0.0,4,0.6666666666666666,4,0.6666666666666666,2,0.3333333333333333
-87.6235,41.8925,567,0,0.0,437,0.7707231040564374,437,0.7707231040564374,130,0.2292768959435626,14,0,0.0,8,0.5714285714285714,8,0.5714285714285714,6,0.42857142857142855
-87.6235,41.893,3079,0,0.0,3079,1.0,3079,1.0,0,0.0,9,0,0.0,9,1.0,9,1.0,0,0.0
-87.6235,41.8935,95,0,0.0,85,0.8947368421052632,85,0.8947368421052632,10,0.10526315789473684,3,0,0.0,2,0.6666666666666666,2,0.6666666666666666,1,0.3333333333333333
-87.6235,41.894,1240,0,0.0,1214,0.9790322580645161,1214,0.9790322580645161,26,0.020967741935483872,11,0,0.0,8,0.7272727272727273,8,0.7272727272727273,3,0.2727272727272727
-87.6235,41.8945,983,0,0.0,615,0.6256358087487284,615,0.6256358087487284,368,0.3743641912512716,31,0,0.0,18,0.5806451612903226,18,0.5806451612903226,13,0.41935483870967744
-87.6235,41.895,255,0,0.0,231,0.9058823529411765,231,0.9058823529411765,24,0.09411764705882353,3,0,0.0,2,0.6666666666666666,2,0.6666666666666666,1,0.3333333333333333
-87.6235,41.8955,728,0,0.0,544,0.7472527472527473,544,0.7472527472527473,184,0.25274725274725274,11,0,0.0,8,0.7272727272727273,8,0.7272727272727273,3,0.2727272727272727
-87.6235,41.8965,2610,0,0.0,2451,0.9390804597701149,2451,0.9390804597701149,159,0.06091954022988506,41,0,0.0,28,0.6829268292682927,28,0.6829268292682927,13,0.3170731707317073
-87.623,41.8915,930,0,0.0,908,0.9763440860215054,908,0.9763440860215054,22,0.023655913978494623,16,0,0.0,11,0.6875,11,0.6875,5,0.3125
-87.623,41.892,51,0,0.0,51,1.0,51,1.0,0,0.0,1,0,0.0,1,1.0,1,1.0,0,0.0
-87.623,41.8925,1034,0,0.0,984,0.9516441005802708,984,0.9516441005802708,50,0.048355899419729204,3,0,0.0,2,0.6666666666666666,2,0.6666666666666666,1,0.3333333333333333
-87.623,41.893,1101,0,0.0,1001,0.9091734786557675,1001,0.9091734786557675,100,0.09082652134423251,35,0,0.0,23,0.6571428571428571,23,0.6571428571428571,12,0.34285714285714286
-87.623,41.894,974,0,0.0,974,1.0,974,1.0,0,0.0,25,0,0.0,25,1.0,25,1.0,0,0.0
-87.623,41.8945,1311,0,0.0,1156,0.881769641495042,1156,0.881769641495042,155,0.11823035850495804,19,0,0.0,15,0.7894736842105263,15,0.7894736842105263,4,0.21052631578947367
-87.623,41.895,189,0,0.0,189,1.0,189,1.0,0,0.0,4,0,0.0,4,1.0,4,1.0,0,0.0
-87.623,41.8955,1018,0,0.0,753,0.7396856581532416,753,0.7396856581532416,265,0.26031434184675833,15,0,0.0,13,0.8666666666666667,13,0.8666666666666667,2,0.13333333333333333
-87.623,41.8965,685,0,0.0,603,0.8802919708029197,603,0.8802919708029197,82,0.11970802919708029,24,0,0.0,17,0.7083333333333334,17,0.7083333333333334,7,0.2916666666666667
-87.6225,41.8915,1644,0,0.0,1609,0.9787104622871047,1609,0.9787104622871047,35,0.021289537712895375,24,0,0.0,17,0.7083333333333334,17,0.7083333333333334,7,0.2916666666666667
-87.6225,41.892,1284,0,0.0,1255,0.9774143302180686,1255,0.9774143302180686,29,0.022585669781931463,16,0,0.0,11,0.6875,11,0.6875,5,0.3125
-87.6225,41.8925,1800,0,0.0,1718,0.9544444444444444,1718,0.9544444444444444,82,0.04555555555555556,33,0,0.0,25,0.7575757575757576,25,0.7575757575757576,8,0.24242424242424243
-87.6225,41.893,3427,0,0.0,3395,0.9906623869273417,3395,0.9906623869273417,32,0.009337613072658301,25,0,0.0,18,0.72,18,0.72,7,0.28
-87.6225,41.8935,777,0,0.0,734,0.9446589446589446,734,0.9446589446589446,43,0.055341055341055344,24,0,0.0,16,0.6666666666666666,16,0.6666666666666666,8,0.3333333333333333
-87.6225,41.894,2610,0,0.0,2470,0.946360153256705,2470,0.946360153256705,140,0.05363984674329502,27,0,0.0,17,0.6296296296296297,17,0.6296296296296297,10,0.37037037037037035
-87.6225,41.8945,3798,0,0.0,2358,0.6208530805687204,2358,0.6208530805687204,1440,0.3791469194312796,30,0,0.0,22,0.7333333333333333,22,0.7333333333333333,8,0.26666666666666666
-87.6225,41.895,763,0,0.0,615,0.8060288335517694,615,0.8060288335517694,148,0.19397116644823068,10,0,0.0,8,0.8,8,0.8,2,0.2
-87.6225,41.8955,1986,0,0.0,1590,0.8006042296072508,1590,0.8006042296072508,396,0.19939577039274925,52,0,0.0,36,0.6923076923076923,36,0.6923076923076923,16,0.3076923076923077
-87.6225,41.896,123,0,0.0,115,0.9349593495934959,115,0.9349593495934959,8,0.06504065040650407,2,0,0.0,1,0.5,1,0.5,1,0.5
-87.6225,41.8965,657,0,0.0,604,0.9193302891933028,604,0.9193302891933028,53,0.0806697108066971,14,0,0.0,11,0.7857142857142857,11,0.7857142857142857,3,0.21428571428571427
-87.622,41.891,41,0,0.0,36,0.8780487804878049,36,0.8780487804878049,5,0.12195121951219512,3,0,0.0,2,0.6666666666666666,2,0.6666666666666666,1,0.3333333333333333
-87.622,41.8915,1551,0,0.0,1459,0.9406834300451322,1459,0.9406834300451322,92,0.05931656995486783,51,0,0.0,32,0.6274509803921569,32,0.6274509803921569,19,0.37254901960784315
-87.622,41.892,196,0,0.0,172,0.8775510204081632,172,0.8775510204081632,24,0.12244897959183673,7,0,0.0,3,0.42857142857142855,3,0.42857142857142855,4,0.5714285714285714
-87.622,41.8925,387,0,0.0,337,0.8708010335917312,337,0.8708010335917312,50,0.12919896640826872,9,0,0.0,6,0.6666666666666666,6,0.6666666666666666,3,0.3333333333333333
-87.622,41.893,795,0,0.0,795,1.0,795,1.0,0,0.0,3,0,0.0,3,1.0,3,1.0,0,0.0
-87.622,41.8935,570,0,0.0,570,1.0,570,1.0,0,0.0,1,0,0.0,1,1.0,1,1.0,0,0.0
-87.622,41.894,1061,0,0.0,1061,1.0,1061,1.0,0,0.0,6,0,0.0,6,1.0,6,1.0,0,0.0
-87.622,41.8945,858,0,0.0,273,0.3181818181818182,273,0.3181818181818182,585,0.6818181818181818,9,0,0.0,5,0.5555555555555556,5,0.5555555555555556,4,0.4444444444444444
-87.622,41.895,356,0,0.0,356,1.0,356,1.0,0,0.0,2,0,0.0,2,1.0,2,1.0,0,0.0
-87.622,41.8955,1470,0,0.0,1073,0.7299319727891157,1073,0.7299319727891157,397,0.27006802721088435,58,0,0.0,33,0.5689655172413793,33,0.5689655172413793,25,0.43103448275862066
-87.622,41.896,83,0,0.0,83,1.0,83,1.0,0,0.0,2,0,0.0,2,1.0,2,1.0,0,0.0
-87.622,41.8965,1201,0,0.0,1096,0.9125728559533722,1096,0.9125728559533722,105,0.08742714404662781,24,0,0.0,16,0.6666666666666666,16,0.6666666666666666,8,0.3333333333333333
-87.6215,41.891,93,0,0.0,74,0.7956989247311828,74,0.7956989247311828,19,0.20430107526881722,4,0,0.0,2,0.5,2,0.5,2,0.5
-87.6215,41.8915,639,0,0.0,558,0.8732394366197183,558,0.8732394366197183,81,0.1267605633802817,40,0,0.0,26,0.65,26,0.65,14,0.35
-87.6215,41.892,44,0,0.0,0,0.0,0,0.0,44,1.0,1,0,0.0,0,0.0,0,0.0,1,1.0
-87.6215,41.8925,404,0,0.0,349,0.8638613861386139,349,0.8638613861386139,55,0.13613861386138615,15,0,0.0,9,0.6,9,0.6,6,0.4
-87.6215,41.893,515,0,0.0,515,1.0,515,1.0,0,0.0,3,0,0.0,3,1.0,3,1.0,0,0.0
-87.6215,41.8935,231,0,0.0,231,1.0,231,1.0,0,0.0,1,0,0.0,1,1.0,1,1.0,0,0.0
-87.6215,41.894,656,0,0.0,656,1.0,656,1.0,0,0.0,5,0,0.0,5,1.0,5,1.0,0,0.0
-87.6215,41.8945,740,0,0.0,543,0.7337837837837838,543,0.7337837837837838,197,0.2662162162162162,19,0,0.0,10,0.5263157894736842,10,0.5263157894736842,9,0.47368421052631576
-87.6215,41.895,263,0,0.0,203,0.7718631178707225,203,0.7718631178707225,60,0.22813688212927757,7,0,0.0,5,0.7142857142857143,5,0.7142857142857143,2,0.2857142857142857
-87.6215,41.8955,1763,0,0.0,1595,0.9047078842881452,1595,0.9047078842881452,168,0.0952921157118548,15,0,0.0,13,0.8666666666666667,13,0.8666666666666667,2,0.13333333333333333
-87.6215,41.896,137,0,0.0,137,1.0,137,1.0,0,0.0,2,0,0.0,2,1.0,2,1.0,0,0.0
-87.6215,41.8965,1750,0,0.0,1662,0.9497142857142857,1662,0.9497142857142857,88,0.05028571428571429,22,0,0.0,16,0.7272727272727273,16,0.7272727272727273,6,0.2727272727272727
-87.6215,41.897,274,0,0.0,274,1.0,274,1.0,0,0.0,2,0,0.0,2,1.0,2,1.0,0,0.0
-87.621,41.891,27,0,0.0,27,1.0,27,1.0,0,0.0,2,0,0.0,2,1.0,2,1.0,0,0.0
-87.621,41.8915,509,0,0.0,475,0.9332023575638507,475,0.9332023575638507,34,0.06679764243614932,22,0,0.0,14,0.6363636363636364,14,0.6363636363636364,8,0.36363636363636365
-87.621,41.892,85,0,0.0,41,0.4823529411764706,41,0.4823529411764706,44,0.5176470588235295,2,0,0.0,1,0.5,1,0.5,1,0.5
-87.621,41.8925,481,0,0.0,445,0.9251559251559252,445,0.9251559251559252,36,0.07484407484407485,3,0,0.0,2,0.6666666666666666,2,0.6666666666666666,1,0.3333333333333333
-87.621,41.893,1545,0,0.0,1527,0.9883495145631068,1527,0.9883495145631068,18,0.011650485436893204,15,0,0.0,10,0.6666666666666666,10,0.6666666666666666,5,0.3333333333333333
-87.621,41.8935,64,0,0.0,64,1.0,64,1.0,0,0.0,1,0,0.0,1,1.0,1,1.0,0,0.0
-87.621,41.894,602,0,0.0,587,0.9750830564784053,587,0.9750830564784053,15,0.024916943521594685,20,0,0.0,17,0.85,17,0.85,3,0.15
-87.621,41.8945,451,0,0.0,371,0.8226164079822617,371,0.8226164079822617,80,0.17738359201773837,13,0,0.0,8,0.6153846153846154,8,0.6153846153846154,5,0.38461538461538464
-87.621,41.895,439,0,0.0,250,0.5694760820045558,250,0.5694760820045558,189,0.4305239179954442,8,0,0.0,5,0.625,5,0.625,3,0.375
-87.621,41.8955,1205,0,0.0,1080,0.8962655601659751,1080,0.8962655601659751,125,0.1037344398340249,34,0,0.0,32,0.9411764705882353,32,0.9411764705882353,2,0.058823529411764705
-87.621,41.896,43,0,0.0,43,1.0,43,1.0,0,0.0,2,0,0.0,2,1.0,2,1.0,0,0.0
-87.621,41.8965,954,0,0.0,941,0.9863731656184487,941,0.9863731656184487,13,0.013626834381551363,15,0,0.0,13,0.8666666666666667,13,0.8666666666666667,2,0.13333333333333333
-87.621,41.897,10,0,0.0,10,1.0,10,1.0,0,0.0,1,0,0.0,1,1.0,1,1.0,0,0.0
-87.6205,41.891,14,0,0.0,14,1.0,14,1.0,0,0.0,1,0,0.0,1,1.0,1,1.0,0,0.0
-87.6205,41.8915,583,0,0.0,544,0.9331046312178388,544,0.9331046312178388,39,0.06689536878216124,25,0,0.0,17,0.68,17,0.68,8,0.32
-87.6205,41.892,590,0,0.0,534,0.9050847457627119,534,0.9050847457627119,56,0.09491525423728814,7,0,0.0,5,0.7142857142857143,5,0.7142857142857143,2,0.2857142857142857
-87.6205,41.8925,1774,0,0.0,1696,0.9560315670800451,1696,0.9560315670800451,78,0.043968432919954906,22,0,0.0,13,0.5909090909090909,13,0.5909090909090909,9,0.4090909090909091
-87.6205,41.893,688,0,0.0,654,0.9505813953488372,654,0.9505813953488372,34,0.04941860465116279,31,0,0.0,24,0.7741935483870968,24,0.7741935483870968,7,0.22580645161290322
-87.6205,41.8935,831,0,0.0,791,0.9518652226233454,791,0.9518652226233454,40,0.048134777376654635,7,0,0.0,5,0.7142857142857143,5,0.7142857142857143,2,0.2857142857142857
-87.6205,41.894,1256,0,0.0,1221,0.9721337579617835,1221,0.9721337579617835,35,0.02786624203821656,28,0,0.0,21,0.75,21,0.75,7,0.25
-87.6205,41.8945,235,0,0.0,184,0.7829787234042553,184,0.7829787234042553,51,0.2170212765957447,3,0,0.0,2,0.6666666666666666,2,0.6666666666666666,1,0.3333333333333333
-87.6205,41.895,1065,0,0.0,896,0.8413145539906103,896,0.8413145539906103,169,0.15868544600938966,17,0,0.0,12,0.7058823529411765,12,0.7058823529411765,5,0.29411764705882354
-87.6205,41.8955,2765,0,0.0,2513,0.9088607594936708,2513,0.9088607594936708,252,0.09113924050632911,11,0,0.0,10,0.9090909090909091,10,0.9090909090909091,1,0.09090909090909091
-87.6205,41.896,109,0,0.0,109,1.0,109,1.0,0,0.0,2,0,0.0,2,1.0,2,1.0,0,0.0
-87.6205,41.8965,1790,0,0.0,1703,0.9513966480446927,1703,0.9513966480446927,87,0.04860335195530726,37,0,0.0,23,0.6216216216216216,23,0.6216216216216216,14,0.3783783783783784
-87.6205,41.897,4,0,0.0,4,1.0,4,1.0,0,0.0,1,0,0.0,1,1.0,1,1.0,0,0.0
-87.62,41.891,1153,0,0.0,1153,1.0,1153,1.0,0,0.0,3,0,0.0,3,1.0,3,1.0,0,0.0
-87.62,41.8915,1548,0,0.0,1519,0.9812661498708011,1519,0.9812661498708011,29,0.018733850129198967,20,0,0.0,14,0.7,14,0.7,6,0.3
-87.62,41.892,2627,0,0.0,1645,0.6261895698515417,1645,0.6261895698515417,982,0.37381043014845833,12,0,0.0,9,0.75,9,0.75,3,0.25
-87.62,41.8925,788,0,0.0,633,0.8032994923857868,633,0.8032994923857868,155,0.1967005076142132,30,0,0.0,19,0.6333333333333333,19,0.6333333333333333,11,0.36666666666666664
-87.62,41.893,1950,0,0.0,1814,0.9302564102564103,1814,0.9302564102564103,136,0.06974358974358974,20,0,0.0,18,0.9,18,0.9,2,0.1
-87.62,41.8935,5253,0,0.0,4374,0.8326670474014849,4374,0.8326670474014849,879,0.16733295259851513,7,0,0.0,5,0.7142857142857143,5,0.7142857142857143,2,0.2857142857142857
-87.62,41.894,2203,0,0.0,1771,0.8039037675896504,1771,0.8039037675896504,432,0.1960962324103495,32,0,0.0,21,0.65625,21,0.65625,11,0.34375
-87.62,41.8945,838,0,0.0,750,0.8949880668257757,750,0.8949880668257757,88,0.10501193317422435,6,0,0.0,4,0.6666666666666666,4,0.6666666666666666,2,0.3333333333333333
-87.62,41.895,3735,0,0.0,3504,0.9381526104417671,3504,0.9381526104417671,231,0.061847389558232935,44,0,0.0,28,0.6363636363636364,28,0.6363636363636364,16,0.36363636363636365
-87.62,41.8955,1946,0,0.0,1785,0.9172661870503597,1785,0.9172661870503597,161,0.08273381294964029,10,0,0.0,8,0.8,8,0.8,2,0.2
-87.62,41.896,946,0,0.0,905,0.9566596194503171,905,0.9566596194503171,41,0.04334038054968287,7,0,0.0,5,0.7142857142857143,5,0.7142857142857143,2,0.2857142857142857
-87.62,41.8965,1745,0,0.0,1499,0.859025787965616,1499,0.859025787965616,246,0.14097421203438396,37,0,0.0,21,0.5675675675675675,21,0.5675675675675675,16,0.43243243243243246
-87.62,41.897,18,0,0.0,18,1.0,18,1.0,0,0.0,1,0,0.0,1,1.0,1,1.0,0,0.0
