grid_lat,grid_lon,total_sample,mw_sample,mw_ratio,sub6_sample,sub6_ratio,5g_sample,5g_sample,lte_sample,lte_ratio,total_cs_sample,mw_cs_sample,mw_cs_ratio,sub6_cs_sample,sub6_cs_ratio,5g_cs_sample,5g_cs_sample,lte_cs_sample,lte_cs_ratio
-86.1665,39.7665,38,0,0.0,38,1.0,38,1.0,0,0.0,1,0,0.0,1,1.0,1,1.0,0,0.0
-86.1665,39.767,2947,0,0.0,2735,0.9280624363759755,2735,0.9280624363759755,212,0.07193756362402443,34,0,0.0,28,0.8235294117647058,28,0.8235294117647058,6,0.17647058823529413
-86.1665,39.7675,1476,0,0.0,1358,0.9200542005420054,1358,0.9200542005420054,118,0.07994579945799458,29,0,0.0,26,0.896551724137931,26,0.896551724137931,3,0.10344827586206896
-86.1665,39.768,1291,0,0.0,1170,0.9062742060418281,1170,0.9062742060418281,121,0.09372579395817196,29,0,0.0,25,0.8620689655172413,25,0.8620689655172413,4,0.13793103448275862
-86.1665,39.7685,1217,0,0.0,1084,0.8907148726376335,1084,0.8907148726376335,133,0.10928512736236648,30,0,0.0,24,0.8,24,0.8,6,0.2
-86.1665,39.769,1256,0,0.0,1098,0.8742038216560509,1098,0.8742038216560509,158,0.12579617834394904,35,0,0.0,27,0.7714285714285715,27,0.7714285714285715,8,0.22857142857142856
-86.1665,39.7695,1886,0,0.0,1545,0.8191940615058324,1545,0.8191940615058324,341,0.18080593849416754,34,0,0.0,27,0.7941176470588235,27,0.7941176470588235,7,0.20588235294117646
-86.1665,39.77,2109,0,0.0,1146,0.5433854907539118,1146,0.5433854907539118,963,0.4566145092460882,22,0,0.0,17,0.7727272727272727,17,0.7727272727272727,5,0.22727272727272727
-86.1665,39.7705,194,0,0.0,154,0.7938144329896907,154,0.7938144329896907,40,0.20618556701030927,4,0,0.0,3,0.75,3,0.75,1,0.25
-86.1665,39.771,361,0,0.0,320,0.8864265927977839,320,0.8864265927977839,41,0.11357340720221606,10,0,0.0,8,0.8,8,0.8,2,0.2
-86.1665,39.7715,1985,0,0.0,1724,0.8685138539042822,1724,0.8685138539042822,261,0.13148614609571788,16,0,0.0,10,0.625,10,0.625,6,0.375
-86.1665,39.772,1331,0,0.0,1197,0.8993238166791886,1197,0.8993238166791886,134,0.10067618332081142,22,0,0.0,14,0.6363636363636364,14,0.6363636363636364,8,0.36363636363636365
-86.1665,39.7725,823,0,0.0,714,0.8675577156743621,714,0.8675577156743621,109,0.1324422843256379,16,0,0.0,12,0.75,12,0.75,4,0.25
-86.1665,39.773,1037,0,0.0,894,0.8621022179363549,894,0.8621022179363549,143,0.13789778206364514,16,0,0.0,10,0.625,10,0.625,6,0.375
-86.1665,39.7735,1007,0,0.0,879,0.8728897715988083,879,0.8728897715988083,128,0.12711022840119166,21,0,0.0,14,0.6666666666666666,14,0.6666666666666666,7,0.3333333333333333
-86.1665,39.774,691,0,0.0,550,0.7959479015918958,550,0.7959479015918958,141,0.2040520984081042,14,0,0.0,10,0.7142857142857143,10,0.7142857142857143,4,0.2857142857142857
-86.1665,39.7745,490,0,0.0,435,0.8877551020408163,435,0.8877551020408163,55,0.11224489795918367,11,0,0.0,8,0.7272727272727273,8,0.7272727272727273,3,0.2727272727272727
-86.1665,39.775,856,0,0.0,749,0.875,749,0.875,107,0.125,14,0,0.0,9,0.6428571428571429,9,0.6428571428571429,5,0.35714285714285715
-86.1665,39.7755,1113,0,0.0,1029,0.9245283018867925,1029,0.9245283018867925,84,0.07547169811320754,13,0,0.0,11,0.8461538461538461,11,0.8461538461538461,2,0.15384615384615385
-86.1665,39.776,396,0,0.0,316,0.797979797979798,316,0.797979797979798,80,0.20202020202020202,11,0,0.0,8,0.7272727272727273,8,0.7272727272727273,3,0.2727272727272727
-86.1665,39.7765,231,0,0.0,193,0.8354978354978355,193,0.8354978354978355,38,0.1645021645021645,13,0,0.0,9,0.6923076923076923,9,0.6923076923076923,4,0.3076923076923077
-86.1665,39.777,81,0,0.0,76,0.9382716049382716,76,0.9382716049382716,5,0.06172839506172839,5,0,0.0,4,0.8,4,0.8,1,0.2
-86.166,39.767,1244,0,0.0,1094,0.8794212218649518,1094,0.8794212218649518,150,0.12057877813504823,28,0,0.0,23,0.8214285714285714,23,0.8214285714285714,5,0.17857142857142858
-86.166,39.7675,18,0,0.0,0,0.0,0,0.0,18,1.0,0,0,0,0,0,0,0,0,0
-86.166,39.7695,30,0,0.0,30,1.0,30,1.0,0,0.0,1,0,0.0,1,1.0,1,1.0,0,0.0
-86.166,39.77,1499,0,0.0,1236,0.8245496997998666,1236,0.8245496997998666,263,0.1754503002001334,18,0,0.0,14,0.7777777777777778,14,0.7777777777777778,4,0.2222222222222222
-86.166,39.771,159,0,0.0,159,1.0,159,1.0,0,0.0,3,0,0.0,3,1.0,3,1.0,0,0.0
-86.166,39.774,2495,0,0.0,1654,0.6629258517034068,1654,0.6629258517034068,841,0.3370741482965932,12,0,0.0,7,0.5833333333333334,7,0.5833333333333334,5,0.4166666666666667
-86.1655,39.767,21022,0,0.0,14046,0.6681571686804301,14046,0.6681571686804301,6976,0.33184283131957,82,0,0.0,45,0.5487804878048781,45,0.5487804878048781,37,0.45121951219512196
-86.1655,39.7695,32,0,0.0,32,1.0,32,1.0,0,0.0,1,0,0.0,1,1.0,1,1.0,0,0.0
-86.1655,39.77,1016,0,0.0,806,0.7933070866141733,806,0.7933070866141733,210,0.20669291338582677,17,0,0.0,13,0.7647058823529411,13,0.7647058823529411,4,0.23529411764705882
-86.1655,39.771,237,0,0.0,237,1.0,237,1.0,0,0.0,3,0,0.0,3,1.0,3,1.0,0,0.0
-86.1655,39.774,184,0,0.0,151,0.8206521739130435,151,0.8206521739130435,33,0.1793478260869565,4,0,0.0,3,0.75,3,0.75,1,0.25
-86.165,39.767,5536,0,0.0,5046,0.9114884393063584,5046,0.9114884393063584,490,0.08851156069364162,48,0,0.0,40,0.8333333333333334,40,0.8333333333333334,8,0.16666666666666666
-86.165,39.7695,50,0,0.0,50,1.0,50,1.0,0,0.0,1,0,0.0,1,1.0,1,1.0,0,0.0
-86.165,39.77,1073,0,0.0,839,0.7819198508853681,839,0.7819198508853681,234,0.21808014911463186,18,0,0.0,14,0.7777777777777778,14,0.7777777777777778,4,0.2222222222222222
-86.165,39.771,131,0,0.0,131,1.0,131,1.0,0,0.0,3,0,0.0,3,1.0,3,1.0,0,0.0
-86.165,39.774,186,0,0.0,145,0.7795698924731183,145,0.7795698924731183,41,0.22043010752688172,4,0,0.0,3,0.75,3,0.75,1,0.25
-86.1645,39.767,2786,0,0.0,2180,0.782483847810481,2180,0.782483847810481,606,0.21751615218951903,39,0,0.0,33,0.8461538461538461,33,0.8461538461538461,6,0.15384615384615385
-86.1645,39.7695,76,0,0.0,76,1.0,76,1.0,0,0.0,1,0,0.0,1,1.0,1,1.0,0,0.0
-86.1645,39.77,1011,0,0.0,732,0.7240356083086054,732,0.7240356083086054,279,0.27596439169139464,17,0,0.0,12,0.7058823529411765,12,0.7058823529411765,5,0.29411764705882354
-86.1645,39.771,125,0,0.0,125,1.0,125,1.0,0,0.0,3,0,0.0,3,1.0,3,1.0,0,0.0
-86.1645,39.774,790,0,0.0,264,0.3341772151898734,264,0.3341772151898734,526,0.6658227848101266,4,0,0.0,3,0.75,3,0.75,1,0.25
-86.164,39.767,1077,0,0.0,920,0.8542246982358404,920,0.8542246982358404,157,0.1457753017641597,39,0,0.0,32,0.8205128205128205,32,0.8205128205128205,7,0.1794871794871795
-86.164,39.7675,49,0,0.0,49,1.0,49,1.0,0,0.0,3,0,0.0,3,1.0,3,1.0,0,0.0
-86.164,39.7695,789,0,0.0,654,0.8288973384030418,654,0.8288973384030418,135,0.17110266159695817,3,0,0.0,3,1.0,3,1.0,0,0.0
-86.164,39.77,1395,0,0.0,1016,0.72831541218638,1016,0.72831541218638,379,0.2716845878136201,20,0,0.0,15,0.75,15,0.75,5,0.25
-86.164,39.771,138,0,0.0,138,1.0,138,1.0,0,0.0,3,0,0.0,3,1.0,3,1.0,0,0.0
-86.164,39.774,582,0,0.0,546,0.9381443298969072,546,0.9381443298969072,36,0.061855670103092786,7,0,0.0,5,0.7142857142857143,5,0.7142857142857143,2,0.2857142857142857
-86.1635,39.767,1109,0,0.0,912,0.8223624887285843,912,0.8223624887285843,197,0.1776375112714157,33,0,0.0,29,0.8787878787878788,29,0.8787878787878788,4,0.12121212121212122
-86.1635,39.7675,4,0,0.0,4,1.0,4,1.0,0,0.0,1,0,0.0,1,1.0,1,1.0,0,0.0
-86.1635,39.7695,194,0,0.0,143,0.7371134020618557,143,0.7371134020618557,51,0.26288659793814434,5,0,0.0,3,0.6,3,0.6,2,0.4
-86.1635,39.77,2438,0,0.0,1845,0.7567678424938474,1845,0.7567678424938474,593,0.2432321575061526,29,0,0.0,20,0.6896551724137931,20,0.6896551724137931,9,0.3103448275862069
-86.1635,39.771,689,0,0.0,689,1.0,689,1.0,0,0.0,3,0,0.0,3,1.0,3,1.0,0,0.0
-86.1635,39.774,650,0,0.0,580,0.8923076923076924,580,0.8923076923076924,70,0.1076923076923077,17,0,0.0,10,0.5882352941176471,10,0.5882352941176471,7,0.4117647058823529
-86.163,39.767,2084,0,0.0,1747,0.8382917466410749,1747,0.8382917466410749,337,0.16170825335892514,60,0,0.0,48,0.8,48,0.8,12,0.2
-86.163,39.7695,283,0,0.0,207,0.7314487632508834,207,0.7314487632508834,76,0.26855123674911663,9,0,0.0,7,0.7777777777777778,7,0.7777777777777778,2,0.2222222222222222
-86.163,39.77,3634,0,0.0,3383,0.9309301045679692,3383,0.9309301045679692,251,0.06906989543203082,27,0,0.0,21,0.7777777777777778,21,0.7777777777777778,6,0.2222222222222222
-86.163,39.7705,107,0,0.0,107,1.0,107,1.0,0,0.0,2,0,0.0,2,1.0,2,1.0,0,0.0
-86.163,39.771,371,0,0.0,371,1.0,371,1.0,0,0.0,5,0,0.0,5,1.0,5,1.0,0,0.0
-86.163,39.7715,620,0,0.0,585,0.9435483870967742,585,0.9435483870967742,35,0.056451612903225805,8,0,0.0,7,0.875,7,0.875,1,0.125
-86.163,39.772,180,0,0.0,174,0.9666666666666667,174,0.9666666666666667,6,0.03333333333333333,4,0,0.0,3,0.75,3,0.75,1,0.25
-86.163,39.7725,294,0,0.0,294,1.0,294,1.0,0,0.0,3,0,0.0,3,1.0,3,1.0,0,0.0
-86.163,39.773,619,0,0.0,615,0.9935379644588045,615,0.9935379644588045,4,0.006462035541195477,6,0,0.0,5,0.8333333333333334,5,0.8333333333333334,1,0.16666666666666666
-86.163,39.7735,173,0,0.0,173,1.0,173,1.0,0,0.0,3,0,0.0,3,1.0,3,1.0,0,0.0
-86.163,39.774,414,0,0.0,355,0.857487922705314,355,0.857487922705314,59,0.14251207729468598,18,0,0.0,12,0.6666666666666666,12,0.6666666666666666,6,0.3333333333333333
-86.163,39.7745,106,0,0.0,106,1.0,106,1.0,0,0.0,2,0,0.0,2,1.0,2,1.0,0,0.0
-86.163,39.775,118,0,0.0,118,1.0,118,1.0,0,0.0,2,0,0.0,2,1.0,2,1.0,0,0.0
-86.163,39.7755,523,0,0.0,518,0.9904397705544933,518,0.9904397705544933,5,0.009560229445506692,3,0,0.0,2,0.6666666666666666,2,0.6666666666666666,1,0.3333333333333333
-86.163,39.776,102,0,0.0,102,1.0,102,1.0,0,0.0,1,0,0.0,1,1.0,1,1.0,0,0.0
-86.163,39.7765,111,0,0.0,111,1.0,111,1.0,0,0.0,1,0,0.0,1,1.0,1,1.0,0,0.0
-86.163,39.777,111,0,0.0,111,1.0,111,1.0,0,0.0,1,0,0.0,1,1.0,1,1.0,0,0.0
-86.163,39.7775,120,0,0.0,120,1.0,120,1.0,0,0.0,1,0,0.0,1,1.0,1,1.0,0,0.0
-86.1625,39.767,1338,0,0.0,1223,0.914050822122571,1223,0.914050822122571,115,0.08594917787742899,48,0,0.0,42,0.875,42,0.875,6,0.125
-86.1625,39.7695,673,0,0.0,522,0.7756315007429421,522,0.7756315007429421,151,0.22436849925705796,30,0,0.0,24,0.8,24,0.8,6,0.2
-86.1625,39.77,478,0,0.0,386,0.8075313807531381,386,0.8075313807531381,92,0.19246861924686193,20,0,0.0,16,0.8,16,0.8,4,0.2
-86.1625,39.771,209,0,0.0,209,1.0,209,1.0,0,0.0,3,0,0.0,3,1.0,3,1.0,0,0.0
-86.1625,39.774,259,0,0.0,226,0.8725868725868726,226,0.8725868725868726,33,0.1274131274131274,4,0,0.0,3,0.75,3,0.75,1,0.25
-86.162,39.767,2056,0,0.0,1946,0.9464980544747081,1946,0.9464980544747081,110,0.053501945525291826,39,0,0.0,34,0.8717948717948718,34,0.8717948717948718,5,0.1282051282051282
-86.162,39.7675,13,0,0.0,13,1.0,13,1.0,0,0.0,1,0,0.0,1,1.0,1,1.0,0,0.0
-86.162,39.7695,1064,0,0.0,873,0.8204887218045113,873,0.8204887218045113,191,0.17951127819548873,40,0,0.0,30,0.75,30,0.75,10,0.25
-86.162,39.77,162,0,0.0,152,0.9382716049382716,152,0.9382716049382716,10,0.06172839506172839,7,0,0.0,5,0.7142857142857143,5,0.7142857142857143,2,0.2857142857142857
-86.162,39.771,326,0,0.0,326,1.0,326,1.0,0,0.0,3,0,0.0,3,1.0,3,1.0,0,0.0
-86.162,39.774,250,0,0.0,211,0.844,211,0.844,39,0.156,6,0,0.0,4,0.6666666666666666,4,0.6666666666666666,2,0.3333333333333333
-86.1615,39.7665,2946,0,0.0,2350,0.7976917854718262,2350,0.7976917854718262,596,0.2023082145281738,56,0,0.0,39,0.6964285714285714,39,0.6964285714285714,17,0.30357142857142855
-86.1615,39.767,11857,0,0.0,8536,0.7199122880998566,8536,0.7199122880998566,3321,0.28008771190014337,129,0,0.0,83,0.6434108527131783,83,0.6434108527131783,46,0.35658914728682173
-86.1615,39.7675,2696,0,0.0,1622,0.6016320474777448,1622,0.6016320474777448,1074,0.3983679525222552,45,0,0.0,27,0.6,27,0.6,18,0.4
-86.1615,39.768,34233,0,0.0,32645,0.9536120118014781,32645,0.9536120118014781,1588,0.04638798819852189,150,0,0.0,82,0.5466666666666666,82,0.5466666666666666,68,0.4533333333333333
-86.1615,39.7685,4515,0,0.0,2177,0.4821705426356589,2177,0.4821705426356589,2338,0.517829457364341,53,0,0.0,31,0.5849056603773585,31,0.5849056603773585,22,0.41509433962264153
-86.1615,39.769,2537,0,0.0,1491,0.5877020102483248,1491,0.5877020102483248,1046,0.4122979897516752,50,0,0.0,30,0.6,30,0.6,20,0.4
-86.1615,39.7695,5211,0,0.0,3438,0.6597582037996546,3438,0.6597582037996546,1773,0.34024179620034545,62,0,0.0,41,0.6612903225806451,41,0.6612903225806451,21,0.3387096774193548
-86.1615,39.77,1715,0,0.0,1215,0.7084548104956269,1215,0.7084548104956269,500,0.2915451895043732,17,0,0.0,11,0.6470588235294118,11,0.6470588235294118,6,0.35294117647058826
-86.1615,39.7705,878,0,0.0,535,0.6093394077448747,535,0.6093394077448747,343,0.3906605922551253,11,0,0.0,7,0.6363636363636364,7,0.6363636363636364,4,0.36363636363636365
-86.1615,39.771,2234,0,0.0,1902,0.8513876454789615,1902,0.8513876454789615,332,0.1486123545210385,20,0,0.0,14,0.7,14,0.7,6,0.3
-86.1615,39.7715,6166,0,0.0,3124,0.5066493674991891,3124,0.5066493674991891,3042,0.4933506325008109,23,0,0.0,12,0.5217391304347826,12,0.5217391304347826,11,0.4782608695652174
-86.1615,39.772,667,0,0.0,401,0.6011994002998501,401,0.6011994002998501,266,0.3988005997001499,7,0,0.0,5,0.7142857142857143,5,0.7142857142857143,2,0.2857142857142857
-86.1615,39.7725,38153,0,0.0,35097,0.9199014494273059,35097,0.9199014494273059,3056,0.08009855057269415,153,0,0.0,86,0.5620915032679739,86,0.5620915032679739,67,0.43790849673202614
-86.1615,39.773,16228,0,0.0,14220,0.8762632487059403,14220,0.8762632487059403,2008,0.12373675129405964,58,0,0.0,33,0.5689655172413793,33,0.5689655172413793,25,0.43103448275862066
-86.1615,39.7735,25281,0,0.0,23717,0.9381353585696768,23717,0.9381353585696768,1564,0.06186464143032317,85,0,0.0,50,0.5882352941176471,50,0.5882352941176471,35,0.4117647058823529
-86.1615,39.774,302,0,0.0,226,0.7483443708609272,226,0.7483443708609272,76,0.25165562913907286,8,0,0.0,5,0.625,5,0.625,3,0.375
-86.161,39.7665,544,0,0.0,543,0.9981617647058824,543,0.9981617647058824,1,0.001838235294117647,5,0,0.0,5,1.0,5,1.0,0,0.0
-86.161,39.767,5273,0,0.0,4868,0.9231936279157975,4868,0.9231936279157975,405,0.07680637208420255,38,0,0.0,34,0.8947368421052632,34,0.8947368421052632,4,0.10526315789473684
-86.161,39.7675,1,0,0.0,1,1.0,1,1.0,0,0.0,1,0,0.0,1,1.0,1,1.0,0,0.0
-86.161,39.768,41,0,0.0,41,1.0,41,1.0,0,0.0,1,0,0.0,1,1.0,1,1.0,0,0.0
-86.161,39.7685,219,0,0.0,219,1.0,219,1.0,0,0.0,2,0,0.0,2,1.0,2,1.0,0,0.0
-86.161,39.7695,1843,0,0.0,1336,0.7249050461204558,1336,0.7249050461204558,507,0.27509495387954425,22,0,0.0,16,0.7272727272727273,16,0.7272727272727273,6,0.2727272727272727
-86.161,39.77,4547,0,0.0,3725,0.8192214647020013,3725,0.8192214647020013,822,0.18077853529799867,35,0,0.0,21,0.6,21,0.6,14,0.4
-86.161,39.771,192,0,0.0,192,1.0,192,1.0,0,0.0,4,0,0.0,4,1.0,4,1.0,0,0.0
-86.161,39.7715,161,0,0.0,1,0.006211180124223602,1,0.006211180124223602,160,0.9937888198757764,4,0,0.0,1,0.25,1,0.25,3,0.75
-86.161,39.772,279,0,0.0,112,0.4014336917562724,112,0.4014336917562724,167,0.5985663082437276,7,0,0.0,3,0.42857142857142855,3,0.42857142857142855,4,0.5714285714285714
-86.161,39.7725,9751,0,0.0,5145,0.5276381909547738,5145,0.5276381909547738,4606,0.4723618090452261,65,0,0.0,39,0.6,39,0.6,26,0.4
-86.161,39.773,7189,0,0.0,6311,0.8778689664765614,6311,0.8778689664765614,878,0.12213103352343858,55,0,0.0,36,0.6545454545454545,36,0.6545454545454545,19,0.34545454545454546
-86.161,39.7735,1891,0,0.0,1381,0.7303014278159704,1381,0.7303014278159704,510,0.2696985721840296,29,0,0.0,18,0.6206896551724138,18,0.6206896551724138,11,0.3793103448275862
-86.161,39.774,13335,0,0.0,6451,0.48376452943382076,6451,0.48376452943382076,6884,0.5162354705661792,71,0,0.0,37,0.5211267605633803,37,0.5211267605633803,34,0.4788732394366197
-86.161,39.7745,221,0,0.0,144,0.6515837104072398,144,0.6515837104072398,77,0.34841628959276016,3,0,0.0,2,0.6666666666666666,2,0.6666666666666666,1,0.3333333333333333
-86.161,39.775,163,0,0.0,123,0.754601226993865,123,0.754601226993865,40,0.24539877300613497,3,0,0.0,2,0.6666666666666666,2,0.6666666666666666,1,0.3333333333333333
-86.161,39.7755,395,0,0.0,371,0.9392405063291139,371,0.9392405063291139,24,0.060759493670886074,4,0,0.0,3,0.75,3,0.75,1,0.25
-86.161,39.776,53,0,0.0,53,1.0,53,1.0,0,0.0,1,0,0.0,1,1.0,1,1.0,0,0.0
-86.161,39.7765,50,0,0.0,50,1.0,50,1.0,0,0.0,1,0,0.0,1,1.0,1,1.0,0,0.0
-86.161,39.777,256,0,0.0,256,1.0,256,1.0,0,0.0,3,0,0.0,3,1.0,3,1.0,0,0.0
-86.161,39.7775,60,0,0.0,60,1.0,60,1.0,0,0.0,1,0,0.0,1,1.0,1,1.0,0,0.0
-86.1605,39.7665,253,0,0.0,253,1.0,253,1.0,0,0.0,8,0,0.0,8,1.0,8,1.0,0,0.0
-86.1605,39.767,1173,0,0.0,1108,0.9445865302642796,1108,0.9445865302642796,65,0.05541346973572037,55,0,0.0,51,0.9272727272727272,51,0.9272727272727272,4,0.07272727272727272
-86.1605,39.7695,1467,0,0.0,830,0.5657805044308112,830,0.5657805044308112,637,0.4342194955691888,31,0,0.0,21,0.6774193548387096,21,0.6774193548387096,10,0.3225806451612903
-86.1605,39.77,16474,0,0.0,15279,0.9274614544130144,15279,0.9274614544130144,1195,0.07253854558698555,53,0,0.0,29,0.5471698113207547,29,0.5471698113207547,24,0.4528301886792453
-86.1605,39.7705,50,0,0.0,50,1.0,50,1.0,0,0.0,1,0,0.0,1,1.0,1,1.0,0,0.0
-86.1605,39.771,211,0,0.0,211,1.0,211,1.0,0,0.0,4,0,0.0,4,1.0,4,1.0,0,0.0
-86.1605,39.7725,1592,0,0.0,911,0.5722361809045227,911,0.5722361809045227,681,0.4277638190954774,30,0,0.0,18,0.6,18,0.6,12,0.4
-86.1605,39.774,1437,0,0.0,586,0.4077940153096729,586,0.4077940153096729,851,0.592205984690327,22,0,0.0,13,0.5909090909090909,13,0.5909090909090909,9,0.4090909090909091
-86.1605,39.7755,199,0,0.0,195,0.9798994974874372,195,0.9798994974874372,4,0.020100502512562814,5,0,0.0,4,0.8,4,0.8,1,0.2
-86.16,39.7665,9758,0,0.0,7287,0.7467718794835008,7287,0.7467718794835008,2471,0.2532281205164993,38,0,0.0,29,0.7631578947368421,29,0.7631578947368421,9,0.23684210526315788
-86.16,39.767,1534,0,0.0,1194,0.7783572359843546,1194,0.7783572359843546,340,0.22164276401564537,25,0,0.0,20,0.8,20,0.8,5,0.2
-86.16,39.7675,93,0,0.0,65,0.6989247311827957,65,0.6989247311827957,28,0.3010752688172043,2,0,0.0,1,0.5,1,0.5,1,0.5
-86.16,39.768,35,0,0.0,35,1.0,35,1.0,0,0.0,2,0,0.0,2,1.0,2,1.0,0,0.0
-86.16,39.7695,4167,0,0.0,2754,0.6609071274298056,2754,0.6609071274298056,1413,0.3390928725701944,53,0,0.0,27,0.5094339622641509,27,0.5094339622641509,26,0.49056603773584906
-86.16,39.77,162,0,0.0,0,0.0,0,0.0,162,1.0,3,0,0.0,0,0.0,0,0.0,3,1.0
-86.16,39.771,233,0,0.0,233,1.0,233,1.0,0,0.0,4,0,0.0,4,1.0,4,1.0,0,0.0
-86.16,39.7725,2320,0,0.0,1438,0.6198275862068966,1438,0.6198275862068966,882,0.38017241379310346,25,0,0.0,16,0.64,16,0.64,9,0.36
-86.16,39.774,1235,0,0.0,572,0.4631578947368421,572,0.4631578947368421,663,0.5368421052631579,20,0,0.0,12,0.6,12,0.6,8,0.4
-86.16,39.7755,40,0,0.0,40,1.0,40,1.0,0,0.0,1,0,0.0,1,1.0,1,1.0,0,0.0
-86.1595,39.7665,18780,0,0.0,12880,0.6858359957401491,12880,0.6858359957401491,5900,0.3141640042598509,94,0,0.0,60,0.6382978723404256,60,0.6382978723404256,34,0.3617021276595745
-86.1595,39.767,1576,0,0.0,1017,0.6453045685279187,1017,0.6453045685279187,559,0.3546954314720812,27,0,0.0,17,0.6296296296296297,17,0.6296296296296297,10,0.37037037037037035
-86.1595,39.7675,846,0,0.0,449,0.5307328605200946,449,0.5307328605200946,397,0.46926713947990545,16,0,0.0,9,0.5625,9,0.5625,7,0.4375
-86.1595,39.768,3774,0,0.0,1673,0.44329623741388446,1673,0.44329623741388446,2101,0.5567037625861155,22,0,0.0,10,0.45454545454545453,10,0.45454545454545453,12,0.5454545454545454
-86.1595,39.7685,1673,0,0.0,1199,0.7166766288105201,1199,0.7166766288105201,474,0.28332337118948,21,0,0.0,14,0.6666666666666666,14,0.6666666666666666,7,0.3333333333333333
-86.1595,39.769,1104,0,0.0,651,0.5896739130434783,651,0.5896739130434783,453,0.41032608695652173,16,0,0.0,10,0.625,10,0.625,6,0.375
-86.1595,39.7695,11624,0,0.0,4176,0.35925671025464556,4176,0.35925671025464556,7448,0.6407432897453544,67,0,0.0,33,0.4925373134328358,33,0.4925373134328358,34,0.5074626865671642
-86.1595,39.77,1458,0,0.0,990,0.6790123456790124,990,0.6790123456790124,468,0.32098765432098764,28,0,0.0,15,0.5357142857142857,15,0.5357142857142857,13,0.4642857142857143
-86.1595,39.7705,1029,0,0.0,760,0.738581146744412,760,0.738581146744412,269,0.26141885325558795,18,0,0.0,12,0.6666666666666666,12,0.6666666666666666,6,0.3333333333333333
-86.1595,39.771,18139,0,0.0,16644,0.9175809030266278,16644,0.9175809030266278,1495,0.0824190969733723,73,0,0.0,41,0.5616438356164384,41,0.5616438356164384,32,0.4383561643835616
-86.1595,39.7715,1040,0,0.0,735,0.7067307692307693,735,0.7067307692307693,305,0.2932692307692308,11,0,0.0,8,0.7272727272727273,8,0.7272727272727273,3,0.2727272727272727
-86.1595,39.772,1958,0,0.0,924,0.47191011235955055,924,0.47191011235955055,1034,0.5280898876404494,10,0,0.0,7,0.7,7,0.7,3,0.3
-86.1595,39.7725,8320,0,0.0,5790,0.6959134615384616,5790,0.6959134615384616,2530,0.30408653846153844,42,0,0.0,24,0.5714285714285714,24,0.5714285714285714,18,0.42857142857142855
-86.1595,39.773,1427,0,0.0,661,0.46320953048353186,661,0.46320953048353186,766,0.5367904695164681,25,0,0.0,13,0.52,13,0.52,12,0.48
-86.1595,39.7735,4461,0,0.0,1521,0.3409549428379287,1521,0.3409549428379287,2940,0.6590450571620713,21,0,0.0,11,0.5238095238095238,11,0.5238095238095238,10,0.47619047619047616
-86.1595,39.774,5113,0,0.0,1976,0.3864658713084295,1976,0.3864658713084295,3137,0.6135341286915705,31,0,0.0,19,0.6129032258064516,19,0.6129032258064516,12,0.3870967741935484
-86.1595,39.7745,164,0,0.0,164,1.0,164,1.0,0,0.0,2,0,0.0,2,1.0,2,1.0,0,0.0
-86.1595,39.775,30654,0,0.0,29962,0.9774254583414889,29962,0.9774254583414889,692,0.022574541658511124,92,0,0.0,47,0.5108695652173914,47,0.5108695652173914,45,0.4891304347826087
-86.1595,39.7755,83,0,0.0,83,1.0,83,1.0,0,0.0,2,0,0.0,2,1.0,2,1.0,0,0.0
-86.1595,39.776,51,0,0.0,51,1.0,51,1.0,0,0.0,1,0,0.0,1,1.0,1,1.0,0,0.0
-86.1595,39.7765,124,0,0.0,115,0.9274193548387096,115,0.9274193548387096,9,0.07258064516129033,7,0,0.0,5,0.7142857142857143,5,0.7142857142857143,2,0.2857142857142857
-86.1595,39.777,119,0,0.0,106,0.8907563025210085,106,0.8907563025210085,13,0.1092436974789916,7,0,0.0,4,0.5714285714285714,4,0.5714285714285714,3,0.42857142857142855
-86.1595,39.7775,631,0,0.0,631,1.0,631,1.0,0,0.0,2,0,0.0,2,1.0,2,1.0,0,0.0
-86.159,39.767,548,0,0.0,535,0.9762773722627737,535,0.9762773722627737,13,0.023722627737226276,7,0,0.0,5,0.7142857142857143,5,0.7142857142857143,2,0.2857142857142857
-86.159,39.7685,78,0,0.0,78,1.0,78,1.0,0,0.0,1,0,0.0,1,1.0,1,1.0,0,0.0
-86.159,39.7695,159,0,0.0,154,0.9685534591194969,154,0.9685534591194969,5,0.031446540880503145,5,0,0.0,4,0.8,4,0.8,1,0.2
-86.159,39.771,1215,0,0.0,1205,0.9917695473251029,1205,0.9917695473251029,10,0.00823045267489712,8,0,0.0,6,0.75,6,0.75,2,0.25
-86.159,39.7735,48,0,0.0,48,1.0,48,1.0,0,0.0,1,0,0.0,1,1.0,1,1.0,0,0.0
-86.159,39.774,295,0,0.0,258,0.8745762711864407,258,0.8745762711864407,37,0.12542372881355932,16,0,0.0,13,0.8125,13,0.8125,3,0.1875
-86.159,39.7745,50,0,0.0,50,1.0,50,1.0,0,0.0,1,0,0.0,1,1.0,1,1.0,0,0.0
-86.159,39.775,88,0,0.0,88,1.0,88,1.0,0,0.0,4,0,0.0,4,1.0,4,1.0,0,0.0
-86.159,39.7755,108,0,0.0,108,1.0,108,1.0,0,0.0,2,0,0.0,2,1.0,2,1.0,0,0.0
-86.159,39.776,36,0,0.0,36,1.0,36,1.0,0,0.0,1,0,0.0,1,1.0,1,1.0,0,0.0
-86.159,39.7765,3,0,0.0,3,1.0,3,1.0,0,0.0,1,0,0.0,1,1.0,1,1.0,0,0.0
-86.159,39.7775,102,0,0.0,102,1.0,102,1.0,0,0.0,1,0,0.0,1,1.0,1,1.0,0,0.0
-86.1585,39.767,153,0,0.0,153,1.0,153,1.0,0,0.0,3,0,0.0,3,1.0,3,1.0,0,0.0
-86.1585,39.768,156,0,0.0,156,1.0,156,1.0,0,0.0,2,0,0.0,2,1.0,2,1.0,0,0.0
-86.1585,39.7685,1578,0,0.0,1574,0.9974651457541192,1574,0.9974651457541192,4,0.0025348542458808617,4,0,0.0,3,0.75,3,0.75,1,0.25
-86.1585,39.769,194,0,0.0,194,1.0,194,1.0,0,0.0,1,0,0.0,1,1.0,1,1.0,0,0.0
-86.1585,39.7695,177,0,0.0,177,1.0,177,1.0,0,0.0,2,0,0.0,2,1.0,2,1.0,0,0.0
-86.1585,39.771,229,0,0.0,224,0.9781659388646288,224,0.9781659388646288,5,0.021834061135371178,5,0,0.0,4,0.8,4,0.8,1,0.2
-86.1585,39.774,238,0,0.0,200,0.8403361344537815,200,0.8403361344537815,38,0.15966386554621848,10,0,0.0,8,0.8,8,0.8,2,0.2
-86.1585,39.775,6,0,0.0,6,1.0,6,1.0,0,0.0,1,0,0.0,1,1.0,1,1.0,0,0.0
-86.1585,39.7755,35,0,0.0,35,1.0,35,1.0,0,0.0,1,0,0.0,1,1.0,1,1.0,0,0.0
-86.158,39.7665,423,0,0.0,423,1.0,423,1.0,0,0.0,2,0,0.0,2,1.0,2,1.0,0,0.0
-86.158,39.767,17290,0,0.0,11990,0.6934644303065356,11990,0.6934644303065356,5300,0.3065355696934644,64,0,0.0,33,0.515625,33,0.515625,31,0.484375
-86.158,39.7675,8748,0,0.0,6970,0.7967535436671239,6970,0.7967535436671239,1778,0.20324645633287608,41,0,0.0,25,0.6097560975609756,25,0.6097560975609756,16,0.3902439024390244
-86.158,39.768,184,0,0.0,184,1.0,184,1.0,0,0.0,3,0,0.0,3,1.0,3,1.0,0,0.0
-86.158,39.7685,124,0,0.0,124,1.0,124,1.0,0,0.0,3,0,0.0,3,1.0,3,1.0,0,0.0
-86.158,39.769,286,0,0.0,282,0.986013986013986,282,0.986013986013986,4,0.013986013986013986,6,0,0.0,5,0.8333333333333334,5,0.8333333333333334,1,0.16666666666666666
-86.158,39.7695,257,0,0.0,257,1.0,257,1.0,0,0.0,3,0,0.0,3,1.0,3,1.0,0,0.0
-86.158,39.77,75,0,0.0,75,1.0,75,1.0,0,0.0,1,0,0.0,1,1.0,1,1.0,0,0.0
-86.158,39.7705,74,0,0.0,74,1.0,74,1.0,0,0.0,1,0,0.0,1,1.0,1,1.0,0,0.0
-86.158,39.771,1289,0,0.0,1283,0.9953452288595811,1283,0.9953452288595811,6,0.004654771140418929,8,0,0.0,7,0.875,7,0.875,1,0.125
-86.158,39.774,213,0,0.0,143,0.6713615023474179,143,0.6713615023474179,70,0.3286384976525822,4,0,0.0,2,0.5,2,0.5,2,0.5
-86.158,39.775,87,0,0.0,87,1.0,87,1.0,0,0.0,2,0,0.0,2,1.0,2,1.0,0,0.0
-86.158,39.7755,2,0,0.0,2,1.0,2,1.0,0,0.0,1,0,0.0,1,1.0,1,1.0,0,0.0
-86.1575,39.7665,5276,0,0.0,5276,1.0,5276,1.0,0,0.0,2,0,0.0,2,1.0,2,1.0,0,0.0
-86.1575,39.767,18481,0,0.0,18449,0.9982684919647206,18449,0.9982684919647206,32,0.0017315080352794763,15,0,0.0,12,0.8,12,0.8,3,0.2
-86.1575,39.7675,21930,0,0.0,20649,0.9415868673050616,20649,0.9415868673050616,1281,0.05841313269493844,80,0,0.0,44,0.55,44,0.55,36,0.45
-86.1575,39.768,164,0,0.0,164,1.0,164,1.0,0,0.0,3,0,0.0,3,1.0,3,1.0,0,0.0
-86.1575,39.7685,113,0,0.0,113,1.0,113,1.0,0,0.0,2,0,0.0,2,1.0,2,1.0,0,0.0
-86.1575,39.769,145,0,0.0,145,1.0,145,1.0,0,0.0,2,0,0.0,2,1.0,2,1.0,0,0.0
-86.1575,39.7695,213,0,0.0,213,1.0,213,1.0,0,0.0,3,0,0.0,3,1.0,3,1.0,0,0.0
-86.1575,39.77,53,0,0.0,53,1.0,53,1.0,0,0.0,1,0,0.0,1,1.0,1,1.0,0,0.0
-86.1575,39.7705,45,0,0.0,41,0.9111111111111111,41,0.9111111111111111,4,0.08888888888888889,3,0,0.0,2,0.6666666666666666,2,0.6666666666666666,1,0.3333333333333333
-86.1575,39.771,808,0,0.0,798,0.9876237623762376,798,0.9876237623762376,10,0.012376237623762377,10,0,0.0,8,0.8,8,0.8,2,0.2
-86.1575,39.7715,102,0,0.0,98,0.9607843137254902,98,0.9607843137254902,4,0.0392156862745098,4,0,0.0,3,0.75,3,0.75,1,0.25
-86.1575,39.772,87,0,0.0,86,0.9885057471264368,86,0.9885057471264368,1,0.011494252873563218,3,0,0.0,2,0.6666666666666666,2,0.6666666666666666,1,0.3333333333333333
-86.1575,39.7725,84,0,0.0,84,1.0,84,1.0,0,0.0,2,0,0.0,2,1.0,2,1.0,0,0.0
-86.1575,39.773,82,0,0.0,82,1.0,82,1.0,0,0.0,2,0,0.0,2,1.0,2,1.0,0,0.0
-86.1575,39.7735,586,0,0.0,581,0.9914675767918089,581,0.9914675767918089,5,0.008532423208191127,5,0,0.0,4,0.8,4,0.8,1,0.2
-86.1575,39.774,371,0,0.0,296,0.7978436657681941,296,0.7978436657681941,75,0.20215633423180593,8,0,0.0,6,0.75,6,0.75,2,0.25
-86.1575,39.7745,286,0,0.0,281,0.9825174825174825,281,0.9825174825174825,5,0.017482517482517484,5,0,0.0,4,0.8,4,0.8,1,0.2
-86.1575,39.775,173,0,0.0,169,0.976878612716763,169,0.976878612716763,4,0.023121387283236993,5,0,0.0,4,0.8,4,0.8,1,0.2
-86.1575,39.7755,47,0,0.0,47,1.0,47,1.0,0,0.0,2,0,0.0,2,1.0,2,1.0,0,0.0
-86.1575,39.776,42,0,0.0,42,1.0,42,1.0,0,0.0,1,0,0.0,1,1.0,1,1.0,0,0.0
-86.1575,39.7765,41,0,0.0,41,1.0,41,1.0,0,0.0,1,0,0.0,1,1.0,1,1.0,0,0.0
-86.1575,39.777,43,0,0.0,43,1.0,43,1.0,0,0.0,2,0,0.0,2,1.0,2,1.0,0,0.0
-86.1575,39.7775,53,0,0.0,47,0.8867924528301887,47,0.8867924528301887,6,0.11320754716981132,3,0,0.0,2,0.6666666666666666,2,0.6666666666666666,1,0.3333333333333333
-86.157,39.7665,35,0,0.0,35,1.0,35,1.0,0,0.0,2,0,0.0,2,1.0,2,1.0,0,0.0
-86.157,39.767,477,0,0.0,477,1.0,477,1.0,0,0.0,3,0,0.0,3,1.0,3,1.0,0,0.0
-86.157,39.768,8459,0,0.0,7921,0.9363991015486464,7921,0.9363991015486464,538,0.06360089845135358,38,0,0.0,21,0.5526315789473685,21,0.5526315789473685,17,0.4473684210526316
-86.157,39.7685,24186,0,0.0,20162,0.8336227569668403,20162,0.8336227569668403,4024,0.16637724303315968,79,0,0.0,38,0.4810126582278481,38,0.4810126582278481,41,0.5189873417721519
-86.157,39.7695,135,0,0.0,125,0.9259259259259259,125,0.9259259259259259,10,0.07407407407407407,6,0,0.0,4,0.6666666666666666,4,0.6666666666666666,2,0.3333333333333333
-86.157,39.771,1965,0,0.0,1960,0.9974554707379135,1960,0.9974554707379135,5,0.002544529262086514,6,0,0.0,5,0.8333333333333334,5,0.8333333333333334,1,0.16666666666666666
-86.157,39.774,294,0,0.0,193,0.6564625850340136,193,0.6564625850340136,101,0.3435374149659864,7,0,0.0,5,0.7142857142857143,5,0.7142857142857143,2,0.2857142857142857
-86.1565,39.7665,78,0,0.0,78,1.0,78,1.0,0,0.0,2,0,0.0,2,1.0,2,1.0,0,0.0
-86.1565,39.767,166,0,0.0,166,1.0,166,1.0,0,0.0,3,0,0.0,3,1.0,3,1.0,0,0.0
-86.1565,39.768,39,0,0.0,39,1.0,39,1.0,0,0.0,1,0,0.0,1,1.0,1,1.0,0,0.0
-86.1565,39.7685,14264,0,0.0,13302,0.9325574873808189,13302,0.9325574873808189,962,0.06744251261918116,50,0,0.0,26,0.52,26,0.52,24,0.48
-86.1565,39.7695,722,0,0.0,702,0.9722991689750693,702,0.9722991689750693,20,0.027700831024930747,11,0,0.0,7,0.6363636363636364,7,0.6363636363636364,4,0.36363636363636365
-86.1565,39.771,1396,0,0.0,1391,0.9964183381088825,1391,0.9964183381088825,5,0.0035816618911174787,6,0,0.0,5,0.8333333333333334,5,0.8333333333333334,1,0.16666666666666666
-86.1565,39.774,275,0,0.0,183,0.6654545454545454,183,0.6654545454545454,92,0.33454545454545453,8,0,0.0,5,0.625,5,0.625,3,0.375
-86.156,39.7665,259,0,0.0,259,1.0,259,1.0,0,0.0,4,0,0.0,4,1.0,4,1.0,0,0.0
-86.156,39.767,389,0,0.0,379,0.974293059125964,379,0.974293059125964,10,0.02570694087403599,9,0,0.0,7,0.7777777777777778,7,0.7777777777777778,2,0.2222222222222222
-86.156,39.7675,105,0,0.0,105,1.0,105,1.0,0,0.0,2,0,0.0,2,1.0,2,1.0,0,0.0
-86.156,39.768,28229,0,0.0,27702,0.981331255092281,27702,0.981331255092281,527,0.018668744907719012,95,0,0.0,49,0.5157894736842106,49,0.5157894736842106,46,0.4842105263157895
-86.156,39.7685,243,0,0.0,242,0.9958847736625515,242,0.9958847736625515,1,0.00411522633744856,4,0,0.0,3,0.75,3,0.75,1,0.25
-86.156,39.769,138,0,0.0,138,1.0,138,1.0,0,0.0,1,0,0.0,1,1.0,1,1.0,0,0.0
-86.156,39.7695,2313,0,0.0,2307,0.9974059662775616,2307,0.9974059662775616,6,0.0025940337224383916,4,0,0.0,3,0.75,3,0.75,1,0.25
-86.156,39.77,920,0,0.0,901,0.9793478260869565,901,0.9793478260869565,19,0.020652173913043477,13,0,0.0,9,0.6923076923076923,9,0.6923076923076923,4,0.3076923076923077
-86.156,39.7705,160,0,0.0,155,0.96875,155,0.96875,5,0.03125,7,0,0.0,6,0.8571428571428571,6,0.8571428571428571,1,0.14285714285714285
-86.156,39.771,1956,0,0.0,1951,0.9974437627811861,1951,0.9974437627811861,5,0.002556237218813906,17,0,0.0,16,0.9411764705882353,16,0.9411764705882353,1,0.058823529411764705
-86.156,39.7715,481,0,0.0,466,0.9688149688149689,466,0.9688149688149689,15,0.031185031185031187,14,0,0.0,11,0.7857142857142857,11,0.7857142857142857,3,0.21428571428571427
-86.156,39.772,307,0,0.0,307,1.0,307,1.0,0,0.0,5,0,0.0,5,1.0,5,1.0,0,0.0
-86.156,39.7725,2002,0,0.0,1437,0.7177822177822177,1437,0.7177822177822177,565,0.2822177822177822,22,0,0.0,15,0.6818181818181818,15,0.6818181818181818,7,0.3181818181818182
-86.156,39.773,1234,0,0.0,569,0.46110210696920584,569,0.46110210696920584,665,0.5388978930307942,13,0,0.0,10,0.7692307692307693,10,0.7692307692307693,3,0.23076923076923078
-86.156,39.7735,903,0,0.0,450,0.4983388704318937,450,0.4983388704318937,453,0.5016611295681063,12,0,0.0,7,0.5833333333333334,7,0.5833333333333334,5,0.4166666666666667
-86.156,39.774,1994,0,0.0,1271,0.6374122367101304,1271,0.6374122367101304,723,0.36258776328986964,17,0,0.0,11,0.6470588235294118,11,0.6470588235294118,6,0.35294117647058826
-86.156,39.7745,59,0,0.0,29,0.4915254237288136,29,0.4915254237288136,30,0.5084745762711864,2,0,0.0,2,1.0,2,1.0,0,0.0
-86.156,39.775,126,0,0.0,67,0.5317460317460317,67,0.5317460317460317,59,0.46825396825396826,2,0,0.0,1,0.5,1,0.5,1,0.5
-86.1555,39.7665,126,0,0.0,126,1.0,126,1.0,0,0.0,2,0,0.0,2,1.0,2,1.0,0,0.0
-86.1555,39.767,216,0,0.0,216,1.0,216,1.0,0,0.0,3,0,0.0,3,1.0,3,1.0,0,0.0
-86.1555,39.768,213,0,0.0,109,0.5117370892018779,109,0.5117370892018779,104,0.48826291079812206,4,0,0.0,3,0.75,3,0.75,1,0.25
-86.1555,39.7695,241,0,0.0,241,1.0,241,1.0,0,0.0,2,0,0.0,2,1.0,2,1.0,0,0.0
-86.1555,39.771,833,0,0.0,827,0.992797118847539,827,0.992797118847539,6,0.007202881152460984,7,0,0.0,6,0.8571428571428571,6,0.8571428571428571,1,0.14285714285714285
-86.1555,39.7725,1775,0,0.0,1030,0.5802816901408451,1030,0.5802816901408451,745,0.4197183098591549,43,0,0.0,22,0.5116279069767442,22,0.5116279069767442,21,0.4883720930232558
-86.1555,39.773,916,0,0.0,823,0.898471615720524,823,0.898471615720524,93,0.10152838427947598,13,0,0.0,10,0.7692307692307693,10,0.7692307692307693,3,0.23076923076923078
-86.1555,39.7735,971,0,0.0,776,0.7991761071060762,776,0.7991761071060762,195,0.2008238928939238,15,0,0.0,11,0.7333333333333333,11,0.7333333333333333,4,0.26666666666666666
-86.1555,39.774,4836,0,0.0,2637,0.5452853598014888,2637,0.5452853598014888,2199,0.45471464019851116,35,0,0.0,24,0.6857142857142857,24,0.6857142857142857,11,0.3142857142857143
-86.1555,39.7745,1263,0,0.0,744,0.5890736342042755,744,0.5890736342042755,519,0.41092636579572445,23,0,0.0,14,0.6086956521739131,14,0.6086956521739131,9,0.391304347826087
-86.1555,39.775,6342,0,0.0,4279,0.6747082939135919,4279,0.6747082939135919,2063,0.32529170608640806,46,0,0.0,29,0.6304347826086957,29,0.6304347826086957,17,0.3695652173913043
-86.1555,39.7755,3945,0,0.0,2311,0.5858048162230671,2311,0.5858048162230671,1634,0.4141951837769328,30,0,0.0,23,0.7666666666666667,23,0.7666666666666667,7,0.23333333333333334
-86.1555,39.776,103,0,0.0,103,1.0,103,1.0,0,0.0,1,0,0.0,1,1.0,1,1.0,0,0.0
-86.1555,39.7765,95,0,0.0,95,1.0,95,1.0,0,0.0,2,0,0.0,2,1.0,2,1.0,0,0.0
-86.1555,39.777,96,0,0.0,96,1.0,96,1.0,0,0.0,2,0,0.0,2,1.0,2,1.0,0,0.0
-86.1555,39.7775,116,0,0.0,116,1.0,116,1.0,0,0.0,2,0,0.0,2,1.0,2,1.0,0,0.0
-86.155,39.7665,97,0,0.0,97,1.0,97,1.0,0,0.0,2,0,0.0,2,1.0,2,1.0,0,0.0
-86.155,39.767,124,0,0.0,124,1.0,124,1.0,0,0.0,3,0,0.0,3,1.0,3,1.0,0,0.0
-86.155,39.7695,552,0,0.0,539,0.9764492753623188,539,0.9764492753623188,13,0.02355072463768116,7,0,0.0,5,0.7142857142857143,5,0.7142857142857143,2,0.2857142857142857
-86.155,39.771,1694,0,0.0,1689,0.9970484061393152,1689,0.9970484061393152,5,0.0029515938606847697,11,0,0.0,10,0.9090909090909091,10,0.9090909090909091,1,0.09090909090909091
-86.155,39.7725,981,0,0.0,711,0.7247706422018348,711,0.7247706422018348,270,0.27522935779816515,39,0,0.0,27,0.6923076923076923,27,0.6923076923076923,12,0.3076923076923077
-86.155,39.774,273,0,0.0,219,0.8021978021978022,219,0.8021978021978022,54,0.1978021978021978,10,0,0.0,6,0.6,6,0.6,4,0.4
-86.155,39.775,1752,0,0.0,1609,0.91837899543379,1609,0.91837899543379,143,0.08162100456621005,23,0,0.0,19,0.8260869565217391,19,0.8260869565217391,4,0.17391304347826086
-86.155,39.7755,1469,0,0.0,1209,0.8230088495575221,1209,0.8230088495575221,260,0.17699115044247787,16,0,0.0,14,0.875,14,0.875,2,0.125
-86.1545,39.7665,534,0,0.0,529,0.9906367041198502,529,0.9906367041198502,5,0.009363295880149813,9,0,0.0,8,0.8888888888888888,8,0.8888888888888888,1,0.1111111111111111
-86.1545,39.767,173,0,0.0,164,0.9479768786127167,164,0.9479768786127167,9,0.05202312138728324,8,0,0.0,6,0.75,6,0.75,2,0.25
-86.1545,39.7675,60,0,0.0,60,1.0,60,1.0,0,0.0,1,0,0.0,1,1.0,1,1.0,0,0.0
-86.1545,39.7685,8,0,0.0,8,1.0,8,1.0,0,0.0,1,0,0.0,1,1.0,1,1.0,0,0.0
-86.1545,39.769,80,0,0.0,80,1.0,80,1.0,0,0.0,1,0,0.0,1,1.0,1,1.0,0,0.0
-86.1545,39.7695,1822,0,0.0,1793,0.9840834248079035,1793,0.9840834248079035,29,0.015916575192096598,18,0,0.0,14,0.7777777777777778,14,0.7777777777777778,4,0.2222222222222222
-86.1545,39.771,2467,0,0.0,2445,0.9910822861775436,2445,0.9910822861775436,22,0.008917713822456425,18,0,0.0,14,0.7777777777777778,14,0.7777777777777778,4,0.2222222222222222
-86.1545,39.7725,2131,0,0.0,2017,0.9465039887376818,2017,0.9465039887376818,114,0.05349601126231816,40,0,0.0,36,0.9,36,0.9,4,0.1
-86.1545,39.774,224,0,0.0,177,0.7901785714285714,177,0.7901785714285714,47,0.20982142857142858,8,0,0.0,5,0.625,5,0.625,3,0.375
-86.1545,39.775,892,0,0.0,732,0.820627802690583,732,0.820627802690583,160,0.17937219730941703,14,0,0.0,11,0.7857142857142857,11,0.7857142857142857,3,0.21428571428571427
-86.1545,39.7755,146,0,0.0,146,1.0,146,1.0,0,0.0,3,0,0.0,3,1.0,3,1.0,0,0.0
-86.154,39.7665,406,0,0.0,406,1.0,406,1.0,0,0.0,6,0,0.0,6,1.0,6,1.0,0,0.0
-86.154,39.767,83,0,0.0,83,1.0,83,1.0,0,0.0,2,0,0.0,2,1.0,2,1.0,0,0.0
-86.154,39.7675,137,0,0.0,137,1.0,137,1.0,0,0.0,3,0,0.0,3,1.0,3,1.0,0,0.0
-86.154,39.768,327,0,0.0,327,1.0,327,1.0,0,0.0,2,0,0.0,2,1.0,2,1.0,0,0.0
-86.154,39.7685,493,0,0.0,481,0.9756592292089249,481,0.9756592292089249,12,0.02434077079107505,7,0,0.0,5,0.7142857142857143,5,0.7142857142857143,2,0.2857142857142857
-86.154,39.769,602,0,0.0,583,0.96843853820598,583,0.96843853820598,19,0.03156146179401993,8,0,0.0,5,0.625,5,0.625,3,0.375
-86.154,39.7695,22096,0,0.0,20224,0.9152787834902245,20224,0.9152787834902245,1872,0.08472121650977553,85,0,0.0,50,0.5882352941176471,50,0.5882352941176471,35,0.4117647058823529
-86.154,39.77,1637,0,0.0,1156,0.7061698228466707,1156,0.7061698228466707,481,0.29383017715332926,16,0,0.0,13,0.8125,13,0.8125,3,0.1875
-86.154,39.7705,1930,0,0.0,1454,0.7533678756476684,1454,0.7533678756476684,476,0.24663212435233162,13,0,0.0,11,0.8461538461538461,11,0.8461538461538461,2,0.15384615384615385
-86.154,39.771,3627,0,0.0,2371,0.6537082988695891,2371,0.6537082988695891,1256,0.3462917011304108,32,0,0.0,17,0.53125,17,0.53125,15,0.46875
-86.154,39.7715,438,0,0.0,430,0.9817351598173516,430,0.9817351598173516,8,0.0182648401826484,7,0,0.0,5,0.7142857142857143,5,0.7142857142857143,2,0.2857142857142857
-86.154,39.772,1139,0,0.0,1139,1.0,1139,1.0,0,0.0,3,0,0.0,3,1.0,3,1.0,0,0.0
-86.154,39.7725,7052,0,0.0,5008,0.7101531480431084,5008,0.7101531480431084,2044,0.28984685195689164,37,0,0.0,29,0.7837837837837838,29,0.7837837837837838,8,0.21621621621621623
-86.154,39.773,2190,0,0.0,1955,0.8926940639269406,1955,0.8926940639269406,235,0.10730593607305935,24,0,0.0,20,0.8333333333333334,20,0.8333333333333334,4,0.16666666666666666
-86.154,39.7735,4041,0,0.0,3128,0.7740658252907696,3128,0.7740658252907696,913,0.22593417470923038,47,0,0.0,36,0.7659574468085106,36,0.7659574468085106,11,0.23404255319148937
-86.154,39.774,1744,0,0.0,1494,0.856651376146789,1494,0.856651376146789,250,0.143348623853211,38,0,0.0,33,0.868421052631579,33,0.868421052631579,5,0.13157894736842105
-86.154,39.7745,4091,0,0.0,3693,0.9027132730383769,3693,0.9027132730383769,398,0.09728672696162308,44,0,0.0,36,0.8181818181818182,36,0.8181818181818182,8,0.18181818181818182
-86.154,39.775,3894,0,0.0,3120,0.8012326656394453,3120,0.8012326656394453,774,0.1987673343605547,49,0,0.0,39,0.7959183673469388,39,0.7959183673469388,10,0.20408163265306123
-86.154,39.7755,136,0,0.0,136,1.0,136,1.0,0,0.0,5,0,0.0,5,1.0,5,1.0,0,0.0
-86.154,39.776,104,0,0.0,98,0.9423076923076923,98,0.9423076923076923,6,0.057692307692307696,4,0,0.0,3,0.75,3,0.75,1,0.25
-86.154,39.7765,150,0,0.0,150,1.0,150,1.0,0,0.0,4,0,0.0,4,1.0,4,1.0,0,0.0
-86.154,39.777,99,0,0.0,99,1.0,99,1.0,0,0.0,3,0,0.0,3,1.0,3,1.0,0,0.0
-86.154,39.7775,37,0,0.0,37,1.0,37,1.0,0,0.0,3,0,0.0,3,1.0,3,1.0,0,0.0
-86.1535,39.7665,2589,0,0.0,2589,1.0,2589,1.0,0,0.0,4,0,0.0,4,1.0,4,1.0,0,0.0
-86.1535,39.7695,1327,0,0.0,871,0.6563677467972872,871,0.6563677467972872,456,0.3436322532027129,31,0,0.0,17,0.5483870967741935,17,0.5483870967741935,14,0.45161290322580644
-86.1535,39.771,1246,0,0.0,861,0.6910112359550562,861,0.6910112359550562,385,0.3089887640449438,27,0,0.0,22,0.8148148148148148,22,0.8148148148148148,5,0.18518518518518517
-86.1535,39.7735,143,0,0.0,93,0.6503496503496503,93,0.6503496503496503,50,0.34965034965034963,6,0,0.0,4,0.6666666666666666,4,0.6666666666666666,2,0.3333333333333333
-86.1535,39.774,345,0,0.0,324,0.9391304347826087,324,0.9391304347826087,21,0.06086956521739131,13,0,0.0,9,0.6923076923076923,9,0.6923076923076923,4,0.3076923076923077
-86.1535,39.775,206,0,0.0,203,0.9854368932038835,203,0.9854368932038835,3,0.014563106796116505,3,0,0.0,2,0.6666666666666666,2,0.6666666666666666,1,0.3333333333333333
-86.1535,39.7775,131,0,0.0,131,1.0,131,1.0,0,0.0,3,0,0.0,3,1.0,3,1.0,0,0.0
-86.153,39.7665,2033,0,0.0,2032,0.999508116084604,2032,0.999508116084604,1,0.0004918839153959665,5,0,0.0,4,0.8,4,0.8,1,0.2
-86.153,39.7695,1328,0,0.0,891,0.670933734939759,891,0.670933734939759,437,0.32906626506024095,14,0,0.0,11,0.7857142857142857,11,0.7857142857142857,3,0.21428571428571427
-86.153,39.771,1226,0,0.0,831,0.6778140293637847,831,0.6778140293637847,395,0.32218597063621535,18,0,0.0,15,0.8333333333333334,15,0.8333333333333334,3,0.16666666666666666
-86.153,39.7735,208,0,0.0,155,0.7451923076923077,155,0.7451923076923077,53,0.2548076923076923,6,0,0.0,4,0.6666666666666666,4,0.6666666666666666,2,0.3333333333333333
-86.153,39.774,113,0,0.0,113,1.0,113,1.0,0,0.0,2,0,0.0,2,1.0,2,1.0,0,0.0
-86.153,39.775,765,0,0.0,765,1.0,765,1.0,0,0.0,3,0,0.0,3,1.0,3,1.0,0,0.0
-86.153,39.7775,81,0,0.0,73,0.9012345679012346,73,0.9012345679012346,8,0.09876543209876543,4,0,0.0,3,0.75,3,0.75,1,0.25
-86.1525,39.7665,1415,0,0.0,1374,0.9710247349823321,1374,0.9710247349823321,41,0.028975265017667843,23,0,0.0,16,0.6956521739130435,16,0.6956521739130435,7,0.30434782608695654
-86.1525,39.767,1115,0,0.0,1107,0.9928251121076234,1107,0.9928251121076234,8,0.007174887892376682,12,0,0.0,10,0.8333333333333334,10,0.8333333333333334,2,0.16666666666666666
-86.1525,39.7675,283,0,0.0,283,1.0,283,1.0,0,0.0,9,0,0.0,9,1.0,9,1.0,0,0.0
-86.1525,39.768,401,0,0.0,401,1.0,401,1.0,0,0.0,4,0,0.0,4,1.0,4,1.0,0,0.0
-86.1525,39.7685,659,0,0.0,646,0.9802731411229135,646,0.9802731411229135,13,0.019726858877086494,10,0,0.0,8,0.8,8,0.8,2,0.2
-86.1525,39.769,265,0,0.0,265,1.0,265,1.0,0,0.0,5,0,0.0,5,1.0,5,1.0,0,0.0
-86.1525,39.7695,4854,0,0.0,4077,0.8399258343634116,4077,0.8399258343634116,777,0.16007416563658838,27,0,0.0,20,0.7407407407407407,20,0.7407407407407407,7,0.25925925925925924
-86.1525,39.77,2489,0,0.0,1875,0.7533145841703496,1875,0.7533145841703496,614,0.24668541582965045,23,0,0.0,16,0.6956521739130435,16,0.6956521739130435,7,0.30434782608695654
-86.1525,39.7705,3396,0,0.0,2469,0.7270318021201413,2469,0.7270318021201413,927,0.27296819787985865,23,0,0.0,16,0.6956521739130435,16,0.6956521739130435,7,0.30434782608695654
-86.1525,39.771,3183,0,0.0,2306,0.7244737668865849,2306,0.7244737668865849,877,0.275526233113415,26,0,0.0,19,0.7307692307692307,19,0.7307692307692307,7,0.2692307692307692
-86.1525,39.7715,362,0,0.0,350,0.9668508287292817,350,0.9668508287292817,12,0.03314917127071823,10,0,0.0,8,0.8,8,0.8,2,0.2
-86.1525,39.772,196,0,0.0,188,0.9591836734693877,188,0.9591836734693877,8,0.04081632653061224,9,0,0.0,7,0.7777777777777778,7,0.7777777777777778,2,0.2222222222222222
-86.1525,39.7725,220,0,0.0,220,1.0,220,1.0,0,0.0,3,0,0.0,3,1.0,3,1.0,0,0.0
-86.1525,39.773,39,0,0.0,39,1.0,39,1.0,0,0.0,2,0,0.0,2,1.0,2,1.0,0,0.0
-86.1525,39.7735,372,0,0.0,208,0.5591397849462365,208,0.5591397849462365,164,0.44086021505376344,6,0,0.0,5,0.8333333333333334,5,0.8333333333333334,1,0.16666666666666666
-86.1525,39.774,99,0,0.0,99,1.0,99,1.0,0,0.0,3,0,0.0,3,1.0,3,1.0,0,0.0
-86.1525,39.775,122,0,0.0,122,1.0,122,1.0,0,0.0,3,0,0.0,3,1.0,3,1.0,0,0.0
-86.1525,39.7775,173,0,0.0,173,1.0,173,1.0,0,0.0,4,0,0.0,4,1.0,4,1.0,0,0.0
-86.152,39.7665,179,0,0.0,179,1.0,179,1.0,0,0.0,2,0,0.0,2,1.0,2,1.0,0,0.0
-86.152,39.767,296,0,0.0,283,0.956081081081081,283,0.956081081081081,13,0.04391891891891892,7,0,0.0,5,0.7142857142857143,5,0.7142857142857143,2,0.2857142857142857
-86.152,39.7695,607,0,0.0,607,1.0,607,1.0,0,0.0,8,0,0.0,8,1.0,8,1.0,0,0.0
-86.152,39.771,250,0,0.0,250,1.0,250,1.0,0,0.0,6,0,0.0,6,1.0,6,1.0,0,0.0
-86.152,39.7715,46,0,0.0,46,1.0,46,1.0,0,0.0,1,0,0.0,1,1.0,1,1.0,0,0.0
-86.152,39.772,214,0,0.0,208,0.9719626168224299,208,0.9719626168224299,6,0.028037383177570093,8,0,0.0,6,0.75,6,0.75,2,0.25
-86.152,39.7725,2060,0,0.0,2048,0.9941747572815534,2048,0.9941747572815534,12,0.005825242718446602,11,0,0.0,9,0.8181818181818182,9,0.8181818181818182,2,0.18181818181818182
-86.152,39.773,368,0,0.0,368,1.0,368,1.0,0,0.0,5,0,0.0,5,1.0,5,1.0,0,0.0
-86.152,39.7735,2118,0,0.0,2046,0.9660056657223796,2046,0.9660056657223796,72,0.0339943342776204,19,0,0.0,14,0.7368421052631579,14,0.7368421052631579,5,0.2631578947368421
-86.152,39.774,1319,0,0.0,1313,0.9954510993176648,1313,0.9954510993176648,6,0.004548900682335102,10,0,0.0,9,0.9,9,0.9,1,0.1
-86.152,39.7745,345,0,0.0,345,1.0,345,1.0,0,0.0,7,0,0.0,7,1.0,7,1.0,0,0.0
-86.152,39.775,490,0,0.0,485,0.9897959183673469,485,0.9897959183673469,5,0.01020408163265306,8,0,0.0,7,0.875,7,0.875,1,0.125
-86.152,39.7755,816,0,0.0,778,0.9534313725490197,778,0.9534313725490197,38,0.04656862745098039,16,0,0.0,11,0.6875,11,0.6875,5,0.3125
-86.152,39.776,169,0,0.0,169,1.0,169,1.0,0,0.0,3,0,0.0,3,1.0,3,1.0,0,0.0
-86.152,39.7765,164,0,0.0,164,1.0,164,1.0,0,0.0,3,0,0.0,3,1.0,3,1.0,0,0.0
-86.152,39.777,25293,0,0.0,23669,0.9357925117621476,23669,0.9357925117621476,1624,0.06420748823785237,71,0,0.0,37,0.5211267605633803,37,0.5211267605633803,34,0.4788732394366197
-86.152,39.7775,1448,0,0.0,1395,0.9633977900552486,1395,0.9633977900552486,53,0.03660220994475138,11,0,0.0,9,0.8181818181818182,9,0.8181818181818182,2,0.18181818181818182
-86.1515,39.7665,1007,0,0.0,1001,0.9940417080436942,1001,0.9940417080436942,6,0.005958291956305859,9,0,0.0,8,0.8888888888888888,8,0.8888888888888888,1,0.1111111111111111
-86.1515,39.767,62,0,0.0,62,1.0,62,1.0,0,0.0,2,0,0.0,2,1.0,2,1.0,0,0.0
-86.1515,39.7695,335,0,0.0,335,1.0,335,1.0,0,0.0,6,0,0.0,6,1.0,6,1.0,0,0.0
-86.1515,39.771,225,0,0.0,225,1.0,225,1.0,0,0.0,4,0,0.0,4,1.0,4,1.0,0,0.0
-86.1515,39.7735,407,0,0.0,355,0.8722358722358723,355,0.8722358722358723,52,0.12776412776412777,7,0,0.0,6,0.8571428571428571,6,0.8571428571428571,1,0.14285714285714285
-86.1515,39.7775,1317,0,0.0,1277,0.9696279422930904,1277,0.9696279422930904,40,0.030372057706909643,16,0,0.0,10,0.625,10,0.625,6,0.375
-86.151,39.7665,2294,0,0.0,2289,0.9978204010462075,2289,0.9978204010462075,5,0.002179598953792502,8,0,0.0,7,0.875,7,0.875,1,0.125
-86.151,39.767,40,0,0.0,40,1.0,40,1.0,0,0.0,1,0,0.0,1,1.0,1,1.0,0,0.0
-86.151,39.7695,852,0,0.0,841,0.9870892018779343,841,0.9870892018779343,11,0.012910798122065728,11,0,0.0,9,0.8181818181818182,9,0.8181818181818182,2,0.18181818181818182
-86.151,39.771,414,0,0.0,405,0.9782608695652174,405,0.9782608695652174,9,0.021739130434782608,6,0,0.0,5,0.8333333333333334,5,0.8333333333333334,1,0.16666666666666666
-86.151,39.7735,312,0,0.0,268,0.8589743589743589,268,0.8589743589743589,44,0.14102564102564102,7,0,0.0,6,0.8571428571428571,6,0.8571428571428571,1,0.14285714285714285
-86.151,39.7775,144,0,0.0,135,0.9375,135,0.9375,9,0.0625,5,0,0.0,4,0.8,4,0.8,1,0.2
-86.1505,39.7665,1427,0,0.0,1417,0.9929922915206727,1417,0.9929922915206727,10,0.00700770847932726,11,0,0.0,9,0.8181818181818182,9,0.8181818181818182,2,0.18181818181818182
-86.1505,39.767,253,0,0.0,253,1.0,253,1.0,0,0.0,4,0,0.0,4,1.0,4,1.0,0,0.0
-86.1505,39.7675,208,0,0.0,208,1.0,208,1.0,0,0.0,4,0,0.0,4,1.0,4,1.0,0,0.0
-86.1505,39.768,398,0,0.0,381,0.957286432160804,381,0.957286432160804,17,0.04271356783919598,8,0,0.0,6,0.75,6,0.75,2,0.25
-86.1505,39.7685,1040,0,0.0,1036,0.9961538461538462,1036,0.9961538461538462,4,0.0038461538461538464,5,0,0.0,4,0.8,4,0.8,1,0.2
-86.1505,39.769,1838,0,0.0,1834,0.9978237214363439,1834,0.9978237214363439,4,0.002176278563656148,10,0,0.0,9,0.9,9,0.9,1,0.1
-86.1505,39.7695,1578,0,0.0,1578,1.0,1578,1.0,0,0.0,9,0,0.0,9,1.0,9,1.0,0,0.0
-86.1505,39.77,397,0,0.0,397,1.0,397,1.0,0,0.0,6,0,0.0,6,1.0,6,1.0,0,0.0
-86.1505,39.7705,626,0,0.0,626,1.0,626,1.0,0,0.0,6,0,0.0,6,1.0,6,1.0,0,0.0
-86.1505,39.771,1612,0,0.0,1592,0.9875930521091811,1592,0.9875930521091811,20,0.01240694789081886,16,0,0.0,13,0.8125,13,0.8125,3,0.1875
-86.1505,39.7715,612,0,0.0,604,0.9869281045751634,604,0.9869281045751634,8,0.013071895424836602,11,0,0.0,10,0.9090909090909091,10,0.9090909090909091,1,0.09090909090909091
-86.1505,39.772,1078,0,0.0,1065,0.9879406307977736,1065,0.9879406307977736,13,0.012059369202226345,11,0,0.0,9,0.8181818181818182,9,0.8181818181818182,2,0.18181818181818182
-86.1505,39.7725,758,0,0.0,753,0.9934036939313984,753,0.9934036939313984,5,0.006596306068601583,7,0,0.0,6,0.8571428571428571,6,0.8571428571428571,1,0.14285714285714285
-86.1505,39.773,1702,0,0.0,1702,1.0,1702,1.0,0,0.0,6,0,0.0,6,1.0,6,1.0,0,0.0
-86.1505,39.7735,2903,0,0.0,2854,0.9831209094040647,2854,0.9831209094040647,49,0.016879090595935238,15,0,0.0,12,0.8,12,0.8,3,0.2
-86.1505,39.774,209,0,0.0,209,1.0,209,1.0,0,0.0,3,0,0.0,3,1.0,3,1.0,0,0.0
-86.1505,39.7745,211,0,0.0,211,1.0,211,1.0,0,0.0,3,0,0.0,3,1.0,3,1.0,0,0.0
-86.1505,39.775,209,0,0.0,209,1.0,209,1.0,0,0.0,3,0,0.0,3,1.0,3,1.0,0,0.0
-86.1505,39.7755,100,0,0.0,100,1.0,100,1.0,0,0.0,3,0,0.0,3,1.0,3,1.0,0,0.0
-86.1505,39.776,1,0,0.0,1,1.0,1,1.0,0,0.0,1,0,0.0,1,1.0,1,1.0,0,0.0
-86.1505,39.7775,169,0,0.0,160,0.9467455621301775,160,0.9467455621301775,9,0.05325443786982249,4,0,0.0,3,0.75,3,0.75,1,0.25
