grid_lat,grid_lon,total_sample,mw_sample,mw_ratio,sub6_sample,sub6_ratio,5g_sample,5g_sample,lte_sample,lte_ratio,total_cs_sample,mw_cs_sample,mw_cs_ratio,sub6_cs_sample,sub6_cs_ratio,5g_cs_sample,5g_cs_sample,lte_cs_sample,lte_cs_ratio
-87.632,41.8745,270,0,0.0,267,0.9888888888888889,267,0.9888888888888889,3,0.011111111111111112,2,0,0.0,1,0.5,1,0.5,1,0.5
-87.632,41.875,46,46,1.0,0,0.0,46,1.0,0,0.0,1,1,1.0,0,0.0,1,1.0,0,0.0
-87.632,41.8755,96,63,0.65625,22,0.22916666666666666,85,0.8854166666666666,11,0.11458333333333333,7,2,0.2857142857142857,2,0.2857142857142857,4,0.5714285714285714,3,0.42857142857142855
-87.632,41.8765,191,0,0.0,123,0.643979057591623,123,0.643979057591623,68,0.35602094240837695,3,0,0.0,2,0.6666666666666666,2,0.6666666666666666,1,0.3333333333333333
-87.632,41.878,46,0,0.0,0,0.0,0,0.0,46,1.0,1,0,0.0,0,0.0,0,0.0,1,1.0
-87.632,41.8805,410,303,0.7390243902439024,0,0.0,303,0.7390243902439024,107,0.26097560975609757,5,2,0.4,0,0.0,2,0.4,3,0.6
-87.632,41.881,159,153,0.9622641509433962,0,0.0,153,0.9622641509433962,6,0.03773584905660377,8,6,0.75,0,0.0,6,0.75,2,0.25
-87.632,41.8815,437,392,0.897025171624714,35,0.08009153318077804,427,0.977116704805492,10,0.02288329519450801,11,7,0.6363636363636364,1,0.09090909090909091,8,0.7272727272727273,3,0.2727272727272727
-87.632,41.882,75,40,0.5333333333333333,35,0.4666666666666667,75,1.0,0,0.0,2,1,0.5,1,0.5,2,1.0,0,0.0
-87.632,41.883,111,70,0.6306306306306306,41,0.36936936936936937,111,1.0,0,0.0,4,2,0.5,2,0.5,4,1.0,0,0.0
-87.632,41.8855,131,0,0.0,34,0.2595419847328244,34,0.2595419847328244,97,0.7404580152671756,2,0,0.0,1,0.5,1,0.5,1,0.5
-87.6315,41.8745,107,0,0.0,107,1.0,107,1.0,0,0.0,1,0,0.0,1,1.0,1,1.0,0,0.0
-87.6315,41.875,143,120,0.8391608391608392,19,0.13286713286713286,139,0.9720279720279721,4,0.027972027972027972,3,1,0.3333333333333333,1,0.3333333333333333,2,0.6666666666666666,1,0.3333333333333333
-87.6315,41.8755,270,188,0.6962962962962963,33,0.12222222222222222,221,0.8185185185185185,49,0.1814814814814815,12,4,0.3333333333333333,3,0.25,7,0.5833333333333334,5,0.4166666666666667
-87.6315,41.876,49,0,0.0,0,0.0,0,0.0,49,1.0,1,0,0.0,0,0.0,0,0.0,1,1.0
-87.6315,41.8765,576,0,0.0,518,0.8993055555555556,518,0.8993055555555556,58,0.10069444444444445,3,0,0.0,2,0.6666666666666666,2,0.6666666666666666,1,0.3333333333333333
-87.6315,41.878,46,0,0.0,0,0.0,0,0.0,46,1.0,1,0,0.0,0,0.0,0,0.0,1,1.0
-87.6315,41.8805,221,40,0.18099547511312217,0,0.0,40,0.18099547511312217,181,0.8190045248868778,10,4,0.4,0,0.0,4,0.4,6,0.6
-87.6315,41.8815,1362,1285,0.9434654919236417,34,0.024963289280469897,1319,0.9684287812041116,43,0.0315712187958884,5,3,0.6,1,0.2,4,0.8,1,0.2
-87.6315,41.882,606,573,0.9455445544554455,33,0.054455445544554455,606,1.0,0,0.0,2,1,0.5,1,0.5,2,1.0,0,0.0
-87.6315,41.883,211,70,0.33175355450236965,141,0.6682464454976303,211,1.0,0,0.0,5,2,0.4,3,0.6,5,1.0,0,0.0
-87.6315,41.884,71,71,1.0,0,0.0,71,1.0,0,0.0,1,1,1.0,0,0.0,1,1.0,0,0.0
-87.6315,41.885,9,0,0.0,0,0.0,0,0.0,9,1.0,1,0,0.0,0,0.0,0,0.0,1,1.0
-87.6315,41.8855,141,0,0.0,41,0.2907801418439716,41,0.2907801418439716,100,0.7092198581560284,2,0,0.0,1,0.5,1,0.5,1,0.5
-87.631,41.8745,583,0,0.0,583,1.0,583,1.0,0,0.0,1,0,0.0,1,1.0,1,1.0,0,0.0
-87.631,41.8755,246,28,0.11382113821138211,115,0.46747967479674796,143,0.5813008130081301,103,0.4186991869918699,5,1,0.2,2,0.4,3,0.6,2,0.4
-87.631,41.876,95,0,0.0,0,0.0,0,0.0,95,1.0,1,0,0.0,0,0.0,0,0.0,1,1.0
-87.631,41.8765,193,0,0.0,110,0.5699481865284974,110,0.5699481865284974,83,0.43005181347150256,3,0,0.0,2,0.6666666666666666,2,0.6666666666666666,1,0.3333333333333333
-87.631,41.877,38,0,0.0,0,0.0,0,0.0,38,1.0,2,0,0.0,0,0.0,0,0.0,2,1.0
-87.631,41.878,55,0,0.0,0,0.0,0,0.0,55,1.0,1,0,0.0,0,0.0,0,0.0,1,1.0
-87.631,41.8785,5,0,0.0,0,0.0,0,0.0,5,1.0,1,0,0.0,0,0.0,0,0.0,1,1.0
-87.631,41.879,65,0,0.0,2,0.03076923076923077,2,0.03076923076923077,63,0.9692307692307692,2,0,0.0,1,0.5,1,0.5,1,0.5
-87.631,41.8795,37,0,0.0,37,1.0,37,1.0,0,0.0,1,0,0.0,1,1.0,1,1.0,0,0.0
-87.631,41.8805,426,374,0.8779342723004695,0,0.0,374,0.8779342723004695,52,0.12206572769953052,8,4,0.5,0,0.0,4,0.5,4,0.5
-87.631,41.881,7,0,0.0,7,1.0,7,1.0,0,0.0,1,0,0.0,1,1.0,1,1.0,0,0.0
-87.631,41.8815,967,852,0.8810754912099276,81,0.08376421923474664,933,0.9648397104446742,34,0.03516028955532575,10,6,0.6,2,0.2,8,0.8,2,0.2
-87.631,41.882,175,142,0.8114285714285714,33,0.18857142857142858,175,1.0,0,0.0,2,1,0.5,1,0.5,2,1.0,0,0.0
-87.631,41.8825,9,0,0.0,0,0.0,0,0.0,9,1.0,1,0,0.0,0,0.0,0,0.0,1,1.0
-87.631,41.883,1142,314,0.27495621716287216,396,0.3467600700525394,710,0.6217162872154116,432,0.37828371278458844,11,3,0.2727272727272727,3,0.2727272727272727,6,0.5454545454545454,5,0.45454545454545453
-87.631,41.8835,96,37,0.3854166666666667,55,0.5729166666666666,92,0.9583333333333333,4,0.041666666666666664,3,1,0.3333333333333333,1,0.3333333333333333,2,0.6666666666666666,1,0.3333333333333333
-87.631,41.884,148,47,0.31756756756756754,52,0.35135135135135137,99,0.6689189189189189,49,0.3310810810810811,3,1,0.3333333333333333,1,0.3333333333333333,2,0.6666666666666666,1,0.3333333333333333
-87.631,41.8845,247,74,0.29959514170040485,74,0.29959514170040485,148,0.5991902834008097,99,0.4008097165991903,7,1,0.14285714285714285,2,0.2857142857142857,3,0.42857142857142855,4,0.5714285714285714
-87.631,41.885,285,0,0.0,128,0.44912280701754387,128,0.44912280701754387,157,0.5508771929824562,8,0,0.0,3,0.375,3,0.375,5,0.625
-87.631,41.8855,1134,0,0.0,646,0.5696649029982364,646,0.5696649029982364,488,0.43033509700176364,18,0,0.0,11,0.6111111111111112,11,0.6111111111111112,7,0.3888888888888889
-87.631,41.886,887,0,0.0,484,0.5456595264937993,484,0.5456595264937993,403,0.45434047350620066,24,0,0.0,15,0.625,15,0.625,9,0.375
-87.6305,41.8745,6622,824,0.12443370582905466,3747,0.5658411356085775,4571,0.6902748414376322,2051,0.3097251585623679,65,4,0.06153846153846154,40,0.6153846153846154,44,0.676923076923077,21,0.3230769230769231
-87.6305,41.875,1584,461,0.29103535353535354,271,0.1710858585858586,732,0.46212121212121215,852,0.5378787878787878,14,3,0.21428571428571427,6,0.42857142857142855,9,0.6428571428571429,5,0.35714285714285715
-87.6305,41.8755,3170,441,0.1391167192429022,1344,0.42397476340694007,1785,0.5630914826498423,1385,0.43690851735015773,40,5,0.125,17,0.425,22,0.55,18,0.45
-87.6305,41.876,3620,571,0.15773480662983425,2421,0.6687845303867404,2992,0.8265193370165747,628,0.1734806629834254,57,5,0.08771929824561403,33,0.5789473684210527,38,0.6666666666666666,19,0.3333333333333333
-87.6305,41.8765,2100,84,0.04,1713,0.8157142857142857,1797,0.8557142857142858,303,0.1442857142857143,38,2,0.05263157894736842,24,0.631578947368421,26,0.6842105263157895,12,0.3157894736842105
-87.6305,41.877,554,58,0.10469314079422383,333,0.6010830324909747,391,0.7057761732851986,163,0.29422382671480146,11,1,0.09090909090909091,6,0.5454545454545454,7,0.6363636363636364,4,0.36363636363636365
-87.6305,41.8775,561,102,0.18181818181818182,359,0.6399286987522281,461,0.82174688057041,100,0.17825311942959002,13,2,0.15384615384615385,8,0.6153846153846154,10,0.7692307692307693,3,0.23076923076923078
-87.6305,41.878,8203,435,0.053029379495306596,5556,0.6773131781055711,5991,0.7303425576008777,2212,0.26965744239912226,109,8,0.07339449541284404,65,0.5963302752293578,73,0.6697247706422018,36,0.3302752293577982
-87.6305,41.8785,3331,40,0.012008405884118884,2302,0.6910837586310418,2342,0.7030921645151607,989,0.2969078354848394,73,1,0.0136986301369863,44,0.6027397260273972,45,0.6164383561643836,28,0.3835616438356164
-87.6305,41.879,4270,0,0.0,2563,0.6002341920374707,2563,0.6002341920374707,1707,0.39976580796252925,65,0,0.0,42,0.6461538461538462,42,0.6461538461538462,23,0.35384615384615387
-87.6305,41.8795,3350,0,0.0,2733,0.815820895522388,2733,0.815820895522388,617,0.18417910447761193,40,0,0.0,27,0.675,27,0.675,13,0.325
-87.6305,41.88,1050,0,0.0,815,0.7761904761904762,815,0.7761904761904762,235,0.22380952380952382,47,0,0.0,34,0.723404255319149,34,0.723404255319149,13,0.2765957446808511
-87.6305,41.8805,8383,671,0.08004294405344149,3193,0.3808898962185375,3864,0.460932840271979,4519,0.539067159728021,164,12,0.07317073170731707,91,0.5548780487804879,103,0.6280487804878049,61,0.3719512195121951
-87.6305,41.881,3371,325,0.09641056066449125,1786,0.5298131118362503,2111,0.6262236725007416,1260,0.3737763274992584,77,11,0.14285714285714285,36,0.4675324675324675,47,0.6103896103896104,30,0.38961038961038963
-87.6305,41.8815,7320,992,0.1355191256830601,2474,0.33797814207650273,3466,0.4734972677595628,3854,0.5265027322404372,113,13,0.11504424778761062,57,0.504424778761062,70,0.6194690265486725,43,0.3805309734513274
-87.6305,41.882,7043,570,0.08093142126934545,5237,0.7435751810308108,5807,0.8245066023001563,1236,0.17549339769984382,189,11,0.0582010582010582,114,0.6031746031746031,125,0.6613756613756614,64,0.3386243386243386
-87.6305,41.8825,1915,271,0.14151436031331593,1082,0.5650130548302872,1353,0.7065274151436032,562,0.2934725848563969,39,5,0.1282051282051282,17,0.4358974358974359,22,0.5641025641025641,17,0.4358974358974359
-87.6305,41.883,8844,991,0.11205336951605609,4136,0.46766169154228854,5127,0.5797150610583446,3717,0.42028493894165536,114,11,0.09649122807017543,29,0.2543859649122807,40,0.3508771929824561,74,0.6491228070175439
-87.6305,41.8835,4830,525,0.10869565217391304,1578,0.3267080745341615,2103,0.43540372670807453,2727,0.5645962732919255,79,7,0.08860759493670886,22,0.27848101265822783,29,0.3670886075949367,50,0.6329113924050633
-87.6305,41.884,7530,434,0.05763612217795485,2519,0.3345285524568393,2953,0.39216467463479415,4577,0.6078353253652058,69,6,0.08695652173913043,23,0.3333333333333333,29,0.42028985507246375,40,0.5797101449275363
-87.6305,41.8845,2096,399,0.19036259541984732,480,0.22900763358778625,879,0.41937022900763354,1217,0.5806297709923665,34,3,0.08823529411764706,10,0.29411764705882354,13,0.38235294117647056,21,0.6176470588235294
-87.6305,41.885,658,0,0.0,168,0.2553191489361702,168,0.2553191489361702,490,0.7446808510638298,16,0,0.0,4,0.25,4,0.25,12,0.75
-87.6305,41.8855,3574,0,0.0,1254,0.35086737548964747,1254,0.35086737548964747,2320,0.6491326245103526,41,0,0.0,18,0.43902439024390244,18,0.43902439024390244,23,0.5609756097560976
-87.6305,41.886,860,0,0.0,566,0.6581395348837209,566,0.6581395348837209,294,0.34186046511627904,23,0,0.0,12,0.5217391304347826,12,0.5217391304347826,11,0.4782608695652174
-87.63,41.8745,337,87,0.258160237388724,229,0.6795252225519288,316,0.9376854599406528,21,0.06231454005934718,8,2,0.25,5,0.625,7,0.875,1,0.125
-87.63,41.875,1087,0,0.0,82,0.07543698252069918,82,0.07543698252069918,1005,0.9245630174793008,4,0,0.0,2,0.5,2,0.5,2,0.5
-87.63,41.8755,531,95,0.17890772128060264,262,0.4934086629001883,357,0.672316384180791,174,0.327683615819209,12,2,0.16666666666666666,6,0.5,8,0.6666666666666666,4,0.3333333333333333
-87.63,41.876,32,0,0.0,6,0.1875,6,0.1875,26,0.8125,3,0,0.0,1,0.3333333333333333,1,0.3333333333333333,2,0.6666666666666666
-87.63,41.8765,1352,0,0.0,1144,0.8461538461538461,1144,0.8461538461538461,208,0.15384615384615385,17,0,0.0,13,0.7647058823529411,13,0.7647058823529411,4,0.23529411764705882
-87.63,41.877,73,0,0.0,26,0.3561643835616438,26,0.3561643835616438,47,0.6438356164383562,3,0,0.0,2,0.6666666666666666,2,0.6666666666666666,1,0.3333333333333333
-87.63,41.8775,79,0,0.0,72,0.9113924050632911,72,0.9113924050632911,7,0.08860759493670886,2,0,0.0,1,0.5,1,0.5,1,0.5
-87.63,41.878,2807,206,0.07338795867474172,1936,0.6897043106519416,2142,0.7630922693266833,665,0.23690773067331672,59,8,0.13559322033898305,32,0.5423728813559322,40,0.6779661016949152,19,0.3220338983050847
-87.63,41.8785,347,23,0.06628242074927954,317,0.9135446685878963,340,0.9798270893371759,7,0.020172910662824207,10,2,0.2,6,0.6,8,0.8,2,0.2
-87.63,41.879,1814,0,0.0,1149,0.6334068357221609,1149,0.6334068357221609,665,0.36659316427783906,27,0,0.0,18,0.6666666666666666,18,0.6666666666666666,9,0.3333333333333333
-87.63,41.8795,136,0,0.0,132,0.9705882352941176,132,0.9705882352941176,4,0.029411764705882353,6,0,0.0,5,0.8333333333333334,5,0.8333333333333334,1,0.16666666666666666
-87.63,41.88,4,4,1.0,0,0.0,4,1.0,0,0.0,1,1,1.0,0,0.0,1,1.0,0,0.0
-87.63,41.8805,6290,80,0.012718600953895072,456,0.0724960254372019,536,0.08521462639109698,5754,0.914785373608903,43,2,0.046511627906976744,16,0.37209302325581395,18,0.4186046511627907,25,0.5813953488372093
-87.63,41.881,556,0,0.0,516,0.9280575539568345,516,0.9280575539568345,40,0.07194244604316546,19,0,0.0,14,0.7368421052631579,14,0.7368421052631579,5,0.2631578947368421
-87.63,41.8815,1104,221,0.20018115942028986,317,0.2871376811594203,538,0.48731884057971014,566,0.5126811594202898,27,7,0.25925925925925924,10,0.37037037037037035,17,0.6296296296296297,10,0.37037037037037035
-87.63,41.882,875,412,0.47085714285714286,377,0.4308571428571429,789,0.9017142857142857,86,0.09828571428571428,20,9,0.45,6,0.3,15,0.75,5,0.25
-87.63,41.883,1312,159,0.1211890243902439,617,0.47027439024390244,776,0.5914634146341463,536,0.40853658536585363,40,6,0.15,11,0.275,17,0.425,23,0.575
-87.63,41.8835,236,90,0.3813559322033898,108,0.4576271186440678,198,0.8389830508474576,38,0.16101694915254236,9,3,0.3333333333333333,3,0.3333333333333333,6,0.6666666666666666,3,0.3333333333333333
-87.63,41.884,1264,190,0.15031645569620253,938,0.7420886075949367,1128,0.8924050632911392,136,0.10759493670886076,29,3,0.10344827586206896,19,0.6551724137931034,22,0.7586206896551724,7,0.2413793103448276
-87.63,41.8845,181,12,0.06629834254143646,130,0.7182320441988951,142,0.7845303867403315,39,0.2154696132596685,10,1,0.1,6,0.6,7,0.7,3,0.3
-87.63,41.8855,178,0,0.0,176,0.9887640449438202,176,0.9887640449438202,2,0.011235955056179775,5,0,0.0,4,0.8,4,0.8,1,0.2
-87.6295,41.8745,782,60,0.07672634271099744,521,0.6662404092071611,581,0.7429667519181585,201,0.2570332480818414,14,2,0.14285714285714285,9,0.6428571428571429,11,0.7857142857142857,3,0.21428571428571427
-87.6295,41.875,124,0,0.0,54,0.43548387096774194,54,0.43548387096774194,70,0.5645161290322581,2,0,0.0,1,0.5,1,0.5,1,0.5
-87.6295,41.8755,2503,327,0.1306432281262485,1987,0.7938473831402317,2314,0.9244906112664802,189,0.07550938873351977,38,3,0.07894736842105263,25,0.6578947368421053,28,0.7368421052631579,10,0.2631578947368421
-87.6295,41.876,964,0,0.0,944,0.979253112033195,944,0.979253112033195,20,0.02074688796680498,18,0,0.0,14,0.7777777777777778,14,0.7777777777777778,4,0.2222222222222222
-87.6295,41.8765,528,0,0.0,280,0.5303030303030303,280,0.5303030303030303,248,0.4696969696969697,13,0,0.0,9,0.6923076923076923,9,0.6923076923076923,4,0.3076923076923077
-87.6295,41.877,155,0,0.0,108,0.6967741935483871,108,0.6967741935483871,47,0.3032258064516129,3,0,0.0,2,0.6666666666666666,2,0.6666666666666666,1,0.3333333333333333
-87.6295,41.8775,67,11,0.16417910447761194,36,0.5373134328358209,47,0.7014925373134329,20,0.29850746268656714,4,1,0.25,1,0.25,2,0.5,2,0.5
-87.6295,41.878,8068,550,0.06817055032226078,5747,0.7123202776400595,6297,0.7804908279623203,1771,0.21950917203767972,113,11,0.09734513274336283,69,0.6106194690265486,80,0.7079646017699115,33,0.2920353982300885
-87.6295,41.8785,128,0,0.0,128,1.0,128,1.0,0,0.0,2,0,0.0,2,1.0,2,1.0,0,0.0
-87.6295,41.879,1204,0,0.0,801,0.665282392026578,801,0.665282392026578,403,0.3347176079734219,34,0,0.0,25,0.7352941176470589,25,0.7352941176470589,9,0.2647058823529412
-87.6295,41.8795,44,3,0.06818181818181818,41,0.9318181818181818,44,1.0,0,0.0,2,1,0.5,1,0.5,2,1.0,0,0.0
-87.6295,41.88,901,730,0.8102108768035516,0,0.0,730,0.8102108768035516,171,0.1897891231964484,7,5,0.7142857142857143,0,0.0,5,0.7142857142857143,2,0.2857142857142857
-87.6295,41.8805,6713,408,0.06077759570981677,500,0.07448234768359899,908,0.13525994339341577,5805,0.8647400566065843,37,3,0.08108108108108109,16,0.43243243243243246,19,0.5135135135135135,18,0.4864864864864865
-87.6295,41.881,664,17,0.025602409638554216,250,0.37650602409638556,267,0.40210843373493976,397,0.5978915662650602,12,2,0.16666666666666666,6,0.5,8,0.6666666666666666,4,0.3333333333333333
-87.6295,41.8815,2937,691,0.23527408920667348,417,0.14198161389172625,1108,0.37725570309839973,1829,0.6227442969016003,52,19,0.36538461538461536,9,0.17307692307692307,28,0.5384615384615384,24,0.46153846153846156
-87.6295,41.882,711,603,0.8481012658227848,37,0.052039381153305204,640,0.90014064697609,71,0.09985935302390998,21,14,0.6666666666666666,1,0.047619047619047616,15,0.7142857142857143,6,0.2857142857142857
-87.6295,41.8825,901,733,0.8135405105438401,0,0.0,733,0.8135405105438401,168,0.1864594894561598,15,12,0.8,0,0.0,12,0.8,3,0.2
-87.6295,41.883,4743,1147,0.24183006535947713,1836,0.3870967741935484,2983,0.6289268395530255,1760,0.37107316044697447,69,21,0.30434782608695654,24,0.34782608695652173,45,0.6521739130434783,24,0.34782608695652173
-87.6295,41.8835,1011,359,0.35509396636993074,314,0.3105835806132542,673,0.6656775469831849,338,0.334322453016815,23,11,0.4782608695652174,7,0.30434782608695654,18,0.782608695652174,5,0.21739130434782608
-87.6295,41.884,4598,1693,0.3682035667681601,1907,0.4147455415397999,3600,0.78294910830796,998,0.21705089169204,84,23,0.27380952380952384,32,0.38095238095238093,55,0.6547619047619048,29,0.34523809523809523
-87.6295,41.8845,1800,194,0.10777777777777778,1207,0.6705555555555556,1401,0.7783333333333333,399,0.22166666666666668,33,4,0.12121212121212122,19,0.5757575757575758,23,0.696969696969697,10,0.30303030303030304
-87.6295,41.885,2157,161,0.0746407046824293,1634,0.7575336114974501,1795,0.8321743161798795,362,0.16782568382012053,24,2,0.08333333333333333,14,0.5833333333333334,16,0.6666666666666666,8,0.3333333333333333
-87.6295,41.8855,2074,105,0.05062680810028929,1657,0.7989392478302797,1762,0.849566055930569,312,0.15043394406943106,38,2,0.05263157894736842,25,0.6578947368421053,27,0.7105263157894737,11,0.2894736842105263
-87.6295,41.886,1488,277,0.18615591397849462,1054,0.7083333333333334,1331,0.894489247311828,157,0.10551075268817205,28,2,0.07142857142857142,15,0.5357142857142857,17,0.6071428571428571,11,0.39285714285714285
-87.629,41.8745,1099,41,0.0373066424021838,797,0.7252047315741583,838,0.7625113739763422,261,0.23748862602365786,14,1,0.07142857142857142,10,0.7142857142857143,11,0.7857142857142857,3,0.21428571428571427
-87.629,41.875,889,0,0.0,849,0.9550056242969629,849,0.9550056242969629,40,0.04499437570303712,7,0,0.0,6,0.8571428571428571,6,0.8571428571428571,1,0.14285714285714285
-87.629,41.8755,2745,95,0.03460837887067395,1717,0.6255009107468124,1812,0.6601092896174863,933,0.33989071038251367,31,2,0.06451612903225806,24,0.7741935483870968,26,0.8387096774193549,5,0.16129032258064516
-87.629,41.876,439,0,0.0,439,1.0,439,1.0,0,0.0,11,0,0.0,11,1.0,11,1.0,0,0.0
-87.629,41.8765,2746,0,0.0,1303,0.4745083758193736,1303,0.4745083758193736,1443,0.5254916241806263,39,0,0.0,30,0.7692307692307693,30,0.7692307692307693,9,0.23076923076923078
-87.629,41.877,860,0,0.0,784,0.9116279069767442,784,0.9116279069767442,76,0.08837209302325581,29,0,0.0,24,0.8275862068965517,24,0.8275862068965517,5,0.1724137931034483
-87.629,41.8775,1105,38,0.034389140271493215,765,0.6923076923076923,803,0.7266968325791855,302,0.27330316742081445,37,1,0.02702702702702703,22,0.5945945945945946,23,0.6216216216216216,14,0.3783783783783784
-87.629,41.878,6242,437,0.0700096123037488,4342,0.6956103812880488,4779,0.7656199935917976,1463,0.2343800064082025,79,6,0.0759493670886076,55,0.6962025316455697,61,0.7721518987341772,18,0.22784810126582278
-87.629,41.8785,2126,764,0.35936030103480715,1267,0.5959548447789276,2031,0.9553151458137348,95,0.044684854186265284,40,7,0.175,25,0.625,32,0.8,8,0.2
-87.629,41.879,4458,686,0.15388066397487662,2453,0.5502467474203678,3139,0.7041274113952445,1319,0.2958725886047555,84,7,0.08333333333333333,56,0.6666666666666666,63,0.75,21,0.25
-87.629,41.8795,877,390,0.44469783352337516,479,0.5461801596351197,869,0.9908779931584948,8,0.009122006841505131,22,6,0.2727272727272727,15,0.6818181818181818,21,0.9545454545454546,1,0.045454545454545456
-87.629,41.88,1151,342,0.29713292788879236,548,0.476107732406603,890,0.7732406602953954,261,0.22675933970460468,15,7,0.4666666666666667,5,0.3333333333333333,12,0.8,3,0.2
-87.629,41.8805,3484,687,0.19718714121699196,341,0.0978760045924225,1028,0.29506314580941445,2456,0.7049368541905855,60,16,0.26666666666666666,13,0.21666666666666667,29,0.48333333333333334,31,0.5166666666666667
-87.629,41.881,1757,336,0.19123505976095617,157,0.08935685828116106,493,0.28059191804211725,1264,0.7194080819578828,21,5,0.23809523809523808,3,0.14285714285714285,8,0.38095238095238093,13,0.6190476190476191
-87.629,41.8815,7473,2575,0.3445737990097685,696,0.09313528703331996,3271,0.43770908604308845,4202,0.5622909139569116,91,31,0.34065934065934067,21,0.23076923076923078,52,0.5714285714285714,39,0.42857142857142855
-87.629,41.882,1217,811,0.666392769104355,80,0.0657354149548069,891,0.7321281840591619,326,0.26787181594083814,29,16,0.5517241379310345,4,0.13793103448275862,20,0.6896551724137931,9,0.3103448275862069
-87.629,41.8825,1392,878,0.6307471264367817,60,0.04310344827586207,938,0.6738505747126438,454,0.3261494252873563,20,13,0.65,1,0.05,14,0.7,6,0.3
-87.629,41.883,1651,635,0.38461538461538464,652,0.3949121744397335,1287,0.7795275590551181,364,0.2204724409448819,48,18,0.375,16,0.3333333333333333,34,0.7083333333333334,14,0.2916666666666667
-87.629,41.8835,1023,300,0.2932551319648094,592,0.5786901270772239,892,0.8719452590420333,131,0.12805474095796676,30,9,0.3,14,0.4666666666666667,23,0.7666666666666667,7,0.23333333333333334
-87.629,41.884,6515,356,0.05464313123561013,5063,0.7771297006907137,5419,0.8317728319263239,1096,0.16822716807367613,79,4,0.05063291139240506,50,0.6329113924050633,54,0.6835443037974683,25,0.31645569620253167
-87.629,41.8845,3091,128,0.04141054674862504,2487,0.8045939825299256,2615,0.8460045292785507,476,0.15399547072144937,55,4,0.07272727272727272,35,0.6363636363636364,39,0.7090909090909091,16,0.2909090909090909
-87.629,41.885,1018,121,0.11886051080550099,833,0.8182711198428291,954,0.93713163064833,64,0.06286836935166994,13,2,0.15384615384615385,8,0.6153846153846154,10,0.7692307692307693,3,0.23076923076923078
-87.629,41.8855,2111,47,0.02226432970156324,1712,0.8109900521080057,1759,0.8332543818095689,352,0.16674561819043107,29,1,0.034482758620689655,19,0.6551724137931034,20,0.6896551724137931,9,0.3103448275862069
-87.629,41.886,224,13,0.05803571428571429,39,0.17410714285714285,52,0.23214285714285715,172,0.7678571428571429,3,1,0.3333333333333333,1,0.3333333333333333,2,0.6666666666666666,1,0.3333333333333333
-87.629,41.8865,1,0,0.0,0,0.0,0,0.0,1,1.0,1,0,0.0,0,0.0,0,0.0,1,1.0
-87.6285,41.8745,470,0,0.0,288,0.6127659574468085,288,0.6127659574468085,182,0.3872340425531915,10,0,0.0,7,0.7,7,0.7,3,0.3
-87.6285,41.875,687,0,0.0,345,0.5021834061135371,345,0.5021834061135371,342,0.4978165938864629,5,0,0.0,3,0.6,3,0.6,2,0.4
-87.6285,41.8755,2059,675,0.32782904322486645,1136,0.5517241379310345,1811,0.879553181155901,248,0.12044681884409908,17,2,0.11764705882352941,11,0.6470588235294118,13,0.7647058823529411,4,0.23529411764705882
-87.6285,41.876,175,113,0.6457142857142857,62,0.35428571428571426,175,1.0,0,0.0,2,1,0.5,1,0.5,2,1.0,0,0.0
-87.6285,41.8765,2146,207,0.09645852749301025,908,0.42311276794035413,1115,0.5195712954333643,1031,0.4804287045666356,32,1,0.03125,15,0.46875,16,0.5,16,0.5
-87.6285,41.877,95,0,0.0,95,1.0,95,1.0,0,0.0,3,0,0.0,3,1.0,3,1.0,0,0.0
-87.6285,41.8775,87,4,0.04597701149425287,83,0.9540229885057471,87,1.0,0,0.0,2,1,0.5,1,0.5,2,1.0,0,0.0
-87.6285,41.878,1254,64,0.051036682615629984,890,0.7097288676236044,954,0.7607655502392344,300,0.23923444976076555,43,3,0.06976744186046512,26,0.6046511627906976,29,0.6744186046511628,14,0.32558139534883723
-87.6285,41.879,1483,0,0.0,1100,0.7417397167902899,1100,0.7417397167902899,383,0.25826028320971006,35,0,0.0,28,0.8,28,0.8,7,0.2
-87.6285,41.8795,318,0,0.0,318,1.0,318,1.0,0,0.0,4,0,0.0,4,1.0,4,1.0,0,0.0
-87.6285,41.8805,917,76,0.08287895310796074,0,0.0,76,0.08287895310796074,841,0.9171210468920392,7,2,0.2857142857142857,0,0.0,2,0.2857142857142857,5,0.7142857142857143
-87.6285,41.8815,1187,174,0.14658803706823925,1005,0.8466722830665543,1179,0.9932603201347936,8,0.006739679865206402,17,5,0.29411764705882354,11,0.6470588235294118,16,0.9411764705882353,1,0.058823529411764705
-87.6285,41.882,446,250,0.5605381165919282,94,0.21076233183856502,344,0.7713004484304933,102,0.22869955156950672,13,7,0.5384615384615384,2,0.15384615384615385,9,0.6923076923076923,4,0.3076923076923077
-87.6285,41.8825,50,46,0.92,0,0.0,46,0.92,4,0.08,3,2,0.6666666666666666,0,0.0,2,0.6666666666666666,1,0.3333333333333333
-87.6285,41.883,729,225,0.30864197530864196,368,0.50480109739369,593,0.8134430727023318,136,0.18655692729766804,21,7,0.3333333333333333,10,0.47619047619047616,17,0.8095238095238095,4,0.19047619047619047
-87.6285,41.8835,81,0,0.0,81,1.0,81,1.0,0,0.0,1,0,0.0,1,1.0,1,1.0,0,0.0
-87.6285,41.884,2810,0,0.0,2211,0.7868327402135231,2211,0.7868327402135231,599,0.21316725978647688,71,0,0.0,51,0.7183098591549296,51,0.7183098591549296,20,0.28169014084507044
-87.6285,41.8845,2437,0,0.0,1467,0.6019696347968814,1467,0.6019696347968814,970,0.3980303652031186,52,0,0.0,35,0.6730769230769231,35,0.6730769230769231,17,0.3269230769230769
-87.6285,41.8855,1324,0,0.0,921,0.695619335347432,921,0.695619335347432,403,0.30438066465256797,18,0,0.0,12,0.6666666666666666,12,0.6666666666666666,6,0.3333333333333333
-87.628,41.8745,623,0,0.0,388,0.622792937399679,388,0.622792937399679,235,0.37720706260032105,14,0,0.0,9,0.6428571428571429,9,0.6428571428571429,5,0.35714285714285715
-87.628,41.8755,368,50,0.1358695652173913,203,0.5516304347826086,253,0.6875,115,0.3125,10,2,0.2,4,0.4,6,0.6,4,0.4
-87.628,41.876,12,0,0.0,12,1.0,12,1.0,0,0.0,1,0,0.0,1,1.0,1,1.0,0,0.0
-87.628,41.8765,870,0,0.0,569,0.6540229885057471,569,0.6540229885057471,301,0.34597701149425286,17,0,0.0,9,0.5294117647058824,9,0.5294117647058824,8,0.47058823529411764
-87.628,41.877,368,0,0.0,3,0.008152173913043478,3,0.008152173913043478,365,0.9918478260869565,3,0,0.0,1,0.3333333333333333,1,0.3333333333333333,2,0.6666666666666666
-87.628,41.8775,42,0,0.0,42,1.0,42,1.0,0,0.0,1,0,0.0,1,1.0,1,1.0,0,0.0
-87.628,41.878,2349,92,0.039165602383993185,1797,0.7650063856960408,1889,0.804171988080034,460,0.19582801191996593,42,1,0.023809523809523808,31,0.7380952380952381,32,0.7619047619047619,10,0.23809523809523808
-87.628,41.879,1121,0,0.0,824,0.7350579839429081,824,0.7350579839429081,297,0.2649420160570919,39,0,0.0,32,0.8205128205128205,32,0.8205128205128205,7,0.1794871794871795
-87.628,41.8795,101,0,0.0,84,0.8316831683168316,84,0.8316831683168316,17,0.16831683168316833,7,0,0.0,5,0.7142857142857143,5,0.7142857142857143,2,0.2857142857142857
-87.628,41.8805,2247,266,0.11838006230529595,0,0.0,266,0.11838006230529595,1981,0.881619937694704,11,4,0.36363636363636365,0,0.0,4,0.36363636363636365,7,0.6363636363636364
-87.628,41.8815,596,92,0.15436241610738255,504,0.8456375838926175,596,1.0,0,0.0,12,3,0.25,9,0.75,12,1.0,0,0.0
-87.628,41.882,669,261,0.3901345291479821,305,0.45590433482810166,566,0.8460388639760837,103,0.15396113602391628,25,7,0.28,11,0.44,18,0.72,7,0.28
-87.628,41.8825,82,0,0.0,55,0.6707317073170732,55,0.6707317073170732,27,0.32926829268292684,3,0,0.0,2,0.6666666666666666,2,0.6666666666666666,1,0.3333333333333333
-87.628,41.883,1924,798,0.41476091476091476,734,0.3814968814968815,1532,0.7962577962577962,392,0.20374220374220375,42,13,0.30952380952380953,15,0.35714285714285715,28,0.6666666666666666,14,0.3333333333333333
-87.628,41.8835,252,0,0.0,252,1.0,252,1.0,0,0.0,3,0,0.0,3,1.0,3,1.0,0,0.0
-87.628,41.884,3466,0,0.0,2529,0.7296595499134448,2529,0.7296595499134448,937,0.2703404500865551,94,0,0.0,65,0.6914893617021277,65,0.6914893617021277,29,0.30851063829787234
-87.628,41.8845,4426,0,0.0,3537,0.7991414369633981,3537,0.7991414369633981,889,0.2008585630366019,79,0,0.0,63,0.7974683544303798,63,0.7974683544303798,16,0.20253164556962025
-87.628,41.885,705,0,0.0,548,0.7773049645390071,548,0.7773049645390071,157,0.2226950354609929,12,0,0.0,9,0.75,9,0.75,3,0.25
-87.628,41.8855,5167,0,0.0,3788,0.7331139926456358,3788,0.7331139926456358,1379,0.26688600735436424,43,0,0.0,36,0.8372093023255814,36,0.8372093023255814,7,0.16279069767441862
-87.628,41.886,8,0,0.0,8,1.0,8,1.0,0,0.0,1,0,0.0,1,1.0,1,1.0,0,0.0
-87.6275,41.8745,2542,56,0.022029897718332022,1786,0.7025963808025177,1842,0.7246262785208497,700,0.2753737214791503,32,1,0.03125,21,0.65625,22,0.6875,10,0.3125
-87.6275,41.875,3875,1270,0.327741935483871,2308,0.5956129032258064,3578,0.9233548387096774,297,0.07664516129032257,22,5,0.22727272727272727,8,0.36363636363636365,13,0.5909090909090909,9,0.4090909090909091
-87.6275,41.8755,11171,299,0.026765732700742995,8116,0.7265240354489303,8415,0.7532897681496733,2756,0.24671023185032673,45,3,0.06666666666666667,24,0.5333333333333333,27,0.6,18,0.4
-87.6275,41.876,2104,148,0.07034220532319392,1646,0.782319391634981,1794,0.8526615969581749,310,0.1473384030418251,25,3,0.12,15,0.6,18,0.72,7,0.28
-87.6275,41.8765,4552,488,0.10720562390158173,2273,0.49934094903339193,2761,0.6065465729349737,1791,0.39345342706502634,67,11,0.16417910447761194,30,0.44776119402985076,41,0.6119402985074627,26,0.3880597014925373
-87.6275,41.877,1012,52,0.05138339920948617,475,0.46936758893280633,527,0.5207509881422925,485,0.4792490118577075,18,1,0.05555555555555555,11,0.6111111111111112,12,0.6666666666666666,6,0.3333333333333333
-87.6275,41.8775,1608,111,0.06902985074626866,1103,0.6859452736318408,1214,0.7549751243781094,394,0.24502487562189054,19,1,0.05263157894736842,11,0.5789473684210527,12,0.631578947368421,7,0.3684210526315789
-87.6275,41.878,5289,55,0.010398941198714312,4270,0.8073359803365475,4325,0.8177349215352618,964,0.18226507846473813,68,1,0.014705882352941176,49,0.7205882352941176,50,0.7352941176470589,18,0.2647058823529412
-87.6275,41.8785,973,0,0.0,786,0.8078108941418294,786,0.8078108941418294,187,0.19218910585817062,19,0,0.0,12,0.631578947368421,12,0.631578947368421,7,0.3684210526315789
-87.6275,41.879,4489,0,0.0,3371,0.7509467587435955,3371,0.7509467587435955,1118,0.24905324125640455,78,0,0.0,56,0.717948717948718,56,0.717948717948718,22,0.28205128205128205
-87.6275,41.8795,2758,5,0.0018129079042784628,1355,0.49129804205946337,1360,0.49311094996374183,1398,0.5068890500362582,52,1,0.019230769230769232,31,0.5961538461538461,32,0.6153846153846154,20,0.38461538461538464
-87.6275,41.88,2269,60,0.026443367122080213,1269,0.5592772146319964,1329,0.5857205817540766,940,0.4142794182459233,38,1,0.02631578947368421,23,0.6052631578947368,24,0.631578947368421,14,0.3684210526315789
-87.6275,41.8805,8648,66,0.007631822386679001,2598,0.3004162812210916,2664,0.3080481036077706,5984,0.6919518963922294,68,2,0.029411764705882353,34,0.5,36,0.5294117647058824,32,0.47058823529411764
-87.6275,41.881,2538,0,0.0,1178,0.4641449960598897,1178,0.4641449960598897,1360,0.5358550039401103,55,0,0.0,30,0.5454545454545454,30,0.5454545454545454,25,0.45454545454545453
-87.6275,41.8815,5891,1,0.00016975046681378373,4182,0.7098964522152436,4183,0.7100662026820573,1708,0.2899337973179426,59,1,0.01694915254237288,28,0.4745762711864407,29,0.4915254237288136,30,0.5084745762711864
-87.6275,41.882,3898,122,0.03129810159055926,2384,0.6115956900974859,2506,0.6428937916880452,1392,0.35710620831195483,65,5,0.07692307692307693,37,0.5692307692307692,42,0.6461538461538462,23,0.35384615384615387
-87.6275,41.8825,1604,0,0.0,1550,0.9663341645885287,1550,0.9663341645885287,54,0.03366583541147132,13,0,0.0,12,0.9230769230769231,12,0.9230769230769231,1,0.07692307692307693
-87.6275,41.883,1785,496,0.27787114845938377,1151,0.6448179271708684,1647,0.9226890756302522,138,0.0773109243697479,43,12,0.27906976744186046,21,0.4883720930232558,33,0.7674418604651163,10,0.23255813953488372
-87.6275,41.8835,2361,25,0.010588733587462939,1849,0.783142736128759,1874,0.7937314697162219,487,0.20626853028377806,27,1,0.037037037037037035,18,0.6666666666666666,19,0.7037037037037037,8,0.2962962962962963
-87.6275,41.884,3963,0,0.0,2584,0.6520312894272016,2584,0.6520312894272016,1379,0.3479687105727984,64,0,0.0,34,0.53125,34,0.53125,30,0.46875
-87.6275,41.8845,4488,0,0.0,2861,0.6374777183600713,2861,0.6374777183600713,1627,0.3625222816399287,72,0,0.0,43,0.5972222222222222,43,0.5972222222222222,29,0.4027777777777778
-87.6275,41.885,3094,25,0.00808015513897867,756,0.24434389140271492,781,0.2524240465416936,2313,0.7475759534583064,23,1,0.043478260869565216,8,0.34782608695652173,9,0.391304347826087,14,0.6086956521739131
-87.6275,41.8855,546,0,0.0,116,0.21245421245421245,116,0.21245421245421245,430,0.7875457875457875,7,0,0.0,2,0.2857142857142857,2,0.2857142857142857,5,0.7142857142857143
-87.627,41.875,173,0,0.0,173,1.0,173,1.0,0,0.0,2,0,0.0,2,1.0,2,1.0,0,0.0
-87.627,41.8755,3933,0,0.0,3099,0.7879481311975591,3099,0.7879481311975591,834,0.2120518688024409,40,0,0.0,25,0.625,25,0.625,15,0.375
-87.627,41.876,244,15,0.06147540983606557,158,0.6475409836065574,173,0.709016393442623,71,0.29098360655737704,10,1,0.1,5,0.5,6,0.6,4,0.4
-87.627,41.8765,4238,939,0.22156677678150072,2502,0.5903728173666823,3441,0.8119395941481831,797,0.1880604058518169,117,21,0.1794871794871795,58,0.49572649572649574,79,0.6752136752136753,38,0.3247863247863248
-87.627,41.877,813,42,0.05166051660516605,465,0.5719557195571956,507,0.6236162361623616,306,0.3763837638376384,11,1,0.09090909090909091,5,0.45454545454545453,6,0.5454545454545454,5,0.45454545454545453
-87.627,41.8775,26,0,0.0,26,1.0,26,1.0,0,0.0,2,0,0.0,2,1.0,2,1.0,0,0.0
-87.627,41.878,1514,0,0.0,1235,0.8157199471598415,1235,0.8157199471598415,279,0.18428005284015853,42,0,0.0,34,0.8095238095238095,34,0.8095238095238095,8,0.19047619047619047
-87.627,41.8785,9,0,0.0,9,1.0,9,1.0,0,0.0,1,0,0.0,1,1.0,1,1.0,0,0.0
-87.627,41.879,1282,0,0.0,596,0.46489859594383776,596,0.46489859594383776,686,0.5351014040561622,33,0,0.0,22,0.6666666666666666,22,0.6666666666666666,11,0.3333333333333333
-87.627,41.8795,1448,0,0.0,1339,0.9247237569060773,1339,0.9247237569060773,109,0.07527624309392265,32,0,0.0,28,0.875,28,0.875,4,0.125
-87.627,41.88,232,0,0.0,161,0.6939655172413793,161,0.6939655172413793,71,0.30603448275862066,5,0,0.0,4,0.8,4,0.8,1,0.2
-87.627,41.8805,1823,55,0.030170049369171694,361,0.19802523313219966,416,0.22819528250137136,1407,0.7718047174986287,22,1,0.045454545454545456,5,0.22727272727272727,6,0.2727272727272727,16,0.7272727272727273
-87.627,41.8815,401,0,0.0,289,0.7206982543640897,289,0.7206982543640897,112,0.2793017456359102,7,0,0.0,4,0.5714285714285714,4,0.5714285714285714,3,0.42857142857142855
-87.627,41.882,1956,22,0.011247443762781187,1128,0.5766871165644172,1150,0.5879345603271984,806,0.4120654396728016,38,1,0.02631578947368421,20,0.5263157894736842,21,0.5526315789473685,17,0.4473684210526316
-87.627,41.883,768,459,0.59765625,249,0.32421875,708,0.921875,60,0.078125,25,13,0.52,6,0.24,19,0.76,6,0.24
-87.627,41.884,1441,0,0.0,368,0.25537820957668284,368,0.25537820957668284,1073,0.7446217904233171,16,0,0.0,3,0.1875,3,0.1875,13,0.8125
-87.627,41.8845,2113,0,0.0,539,0.25508755324183624,539,0.25508755324183624,1574,0.7449124467581637,23,0,0.0,11,0.4782608695652174,11,0.4782608695652174,12,0.5217391304347826
-87.627,41.8855,573,0,0.0,71,0.12390924956369982,71,0.12390924956369982,502,0.8760907504363001,9,0,0.0,1,0.1111111111111111,1,0.1111111111111111,8,0.8888888888888888
-87.6265,41.875,48,0,0.0,48,1.0,48,1.0,0,0.0,2,0,0.0,2,1.0,2,1.0,0,0.0
-87.6265,41.8755,1113,0,0.0,773,0.6945193171608266,773,0.6945193171608266,340,0.3054806828391734,27,0,0.0,15,0.5555555555555556,15,0.5555555555555556,12,0.4444444444444444
-87.6265,41.8765,1236,618,0.5,358,0.2896440129449838,976,0.7896440129449838,260,0.21035598705501618,42,10,0.23809523809523808,16,0.38095238095238093,26,0.6190476190476191,16,0.38095238095238093
-87.6265,41.877,170,48,0.2823529411764706,70,0.4117647058823529,118,0.6941176470588235,52,0.3058823529411765,9,2,0.2222222222222222,4,0.4444444444444444,6,0.6666666666666666,3,0.3333333333333333
-87.6265,41.8775,115,114,0.991304347826087,1,0.008695652173913044,115,1.0,0,0.0,2,1,0.5,1,0.5,2,1.0,0,0.0
-87.6265,41.878,1968,0,0.0,1505,0.7647357723577236,1505,0.7647357723577236,463,0.23526422764227642,57,0,0.0,41,0.7192982456140351,41,0.7192982456140351,16,0.2807017543859649
-87.6265,41.8785,357,0,0.0,353,0.988795518207283,353,0.988795518207283,4,0.011204481792717087,6,0,0.0,5,0.8333333333333334,5,0.8333333333333334,1,0.16666666666666666
-87.6265,41.879,342,0,0.0,192,0.5614035087719298,192,0.5614035087719298,150,0.43859649122807015,13,0,0.0,7,0.5384615384615384,7,0.5384615384615384,6,0.46153846153846156
-87.6265,41.8795,1007,0,0.0,802,0.7964250248262165,802,0.7964250248262165,205,0.2035749751737835,40,0,0.0,32,0.8,32,0.8,8,0.2
-87.6265,41.88,30,0,0.0,30,1.0,30,1.0,0,0.0,2,0,0.0,2,1.0,2,1.0,0,0.0
-87.6265,41.8805,3870,0,0.0,1120,0.28940568475452194,1120,0.28940568475452194,2750,0.710594315245478,55,0,0.0,19,0.34545454545454546,19,0.34545454545454546,36,0.6545454545454545
-87.6265,41.881,340,0,0.0,272,0.8,272,0.8,68,0.2,7,0,0.0,5,0.7142857142857143,5,0.7142857142857143,2,0.2857142857142857
-87.6265,41.8815,812,0,0.0,812,1.0,812,1.0,0,0.0,2,0,0.0,2,1.0,2,1.0,0,0.0
-87.6265,41.882,1513,0,0.0,952,0.6292134831460674,952,0.6292134831460674,561,0.3707865168539326,28,0,0.0,15,0.5357142857142857,15,0.5357142857142857,13,0.4642857142857143
-87.6265,41.883,2162,953,0.44079555966697503,1090,0.5041628122109159,2043,0.9449583718778909,119,0.05504162812210916,53,23,0.4339622641509434,13,0.24528301886792453,36,0.6792452830188679,17,0.32075471698113206
-87.6265,41.8835,258,0,0.0,248,0.9612403100775194,248,0.9612403100775194,10,0.03875968992248062,2,0,0.0,1,0.5,1,0.5,1,0.5
-87.6265,41.884,1849,0,0.0,179,0.09680908599242834,179,0.09680908599242834,1670,0.9031909140075717,24,0,0.0,4,0.16666666666666666,4,0.16666666666666666,20,0.8333333333333334
-87.6265,41.8845,1462,0,0.0,189,0.1292749658002736,189,0.1292749658002736,1273,0.8707250341997264,11,0,0.0,5,0.45454545454545453,5,0.45454545454545453,6,0.5454545454545454
-87.6265,41.885,266,0,0.0,0,0.0,0,0.0,266,1.0,1,0,0.0,0,0.0,0,0.0,1,1.0
-87.6265,41.8855,1063,0,0.0,24,0.022577610536218252,24,0.022577610536218252,1039,0.9774223894637818,8,0,0.0,1,0.125,1,0.125,7,0.875
-87.626,41.8745,1203,388,0.32252701579384874,787,0.6541978387364921,1175,0.9767248545303409,28,0.023275145469659187,19,2,0.10526315789473684,10,0.5263157894736842,12,0.631578947368421,7,0.3684210526315789
-87.626,41.875,413,0,0.0,411,0.9951573849878934,411,0.9951573849878934,2,0.004842615012106538,6,0,0.0,5,0.8333333333333334,5,0.8333333333333334,1,0.16666666666666666
-87.626,41.8755,7943,14,0.0017625582273700113,5823,0.733098325569684,5837,0.734860883797054,2106,0.265139116202946,82,1,0.012195121951219513,53,0.6463414634146342,54,0.6585365853658537,28,0.34146341463414637
-87.626,41.876,834,132,0.15827338129496402,676,0.8105515587529976,808,0.9688249400479616,26,0.03117505995203837,16,2,0.125,13,0.8125,15,0.9375,1,0.0625
-87.626,41.8765,1445,513,0.3550173010380623,746,0.5162629757785467,1259,0.871280276816609,186,0.128719723183391,31,7,0.22580645161290322,15,0.4838709677419355,22,0.7096774193548387,9,0.2903225806451613
-87.626,41.877,1283,45,0.03507404520654715,1105,0.8612626656274357,1150,0.8963367108339828,133,0.10366328916601715,32,2,0.0625,21,0.65625,23,0.71875,9,0.28125
-87.626,41.8775,350,70,0.2,280,0.8,350,1.0,0,0.0,6,1,0.16666666666666666,5,0.8333333333333334,6,1.0,0,0.0
-87.626,41.878,5520,17,0.0030797101449275364,4308,0.7804347826086957,4325,0.7835144927536233,1195,0.2164855072463768,75,2,0.02666666666666667,53,0.7066666666666667,55,0.7333333333333333,20,0.26666666666666666
-87.626,41.8785,764,0,0.0,690,0.9031413612565445,690,0.9031413612565445,74,0.0968586387434555,13,0,0.0,12,0.9230769230769231,12,0.9230769230769231,1,0.07692307692307693
-87.626,41.879,899,0,0.0,688,0.7652947719688543,688,0.7652947719688543,211,0.2347052280311457,17,0,0.0,13,0.7647058823529411,13,0.7647058823529411,4,0.23529411764705882
-87.626,41.8795,3869,0,0.0,3379,0.8733522874127682,3379,0.8733522874127682,490,0.12664771258723184,65,0,0.0,47,0.7230769230769231,47,0.7230769230769231,18,0.27692307692307694
-87.626,41.88,2357,0,0.0,1886,0.8001697072549852,1886,0.8001697072549852,471,0.19983029274501485,28,0,0.0,20,0.7142857142857143,20,0.7142857142857143,8,0.2857142857142857
-87.626,41.8805,7953,0,0.0,5360,0.673959512133786,5360,0.673959512133786,2593,0.32604048786621403,115,0,0.0,57,0.4956521739130435,57,0.4956521739130435,58,0.5043478260869565
-87.626,41.881,4412,33,0.007479601087941976,2971,0.6733907524932004,3004,0.6808703535811423,1408,0.31912964641885766,89,1,0.011235955056179775,53,0.5955056179775281,54,0.6067415730337079,35,0.39325842696629215
-87.626,41.8815,5522,65,0.011771097428467946,5047,0.913980441868888,5112,0.925751539297356,410,0.07424846070264397,56,4,0.07142857142857142,32,0.5714285714285714,36,0.6428571428571429,20,0.35714285714285715
-87.626,41.882,4153,55,0.013243438478208525,2964,0.713700939080183,3019,0.7269443775583915,1134,0.27305562244160847,66,2,0.030303030303030304,43,0.6515151515151515,45,0.6818181818181818,21,0.3181818181818182
-87.626,41.8825,1320,0,0.0,881,0.6674242424242425,881,0.6674242424242425,439,0.3325757575757576,19,0,0.0,11,0.5789473684210527,11,0.5789473684210527,8,0.42105263157894735
-87.626,41.883,5702,321,0.056296036478428624,3870,0.6787092248333918,4191,0.7350052613118204,1511,0.2649947386881796,59,7,0.11864406779661017,35,0.5932203389830508,42,0.711864406779661,17,0.288135593220339
-87.626,41.8835,1813,0,0.0,338,0.18643132928847214,338,0.18643132928847214,1475,0.8135686707115278,24,0,0.0,9,0.375,9,0.375,15,0.625
-87.626,41.884,4191,0,0.0,788,0.18802195180147935,788,0.18802195180147935,3403,0.8119780481985206,53,0,0.0,11,0.20754716981132076,11,0.20754716981132076,42,0.7924528301886793
-87.626,41.8845,2680,0,0.0,456,0.1701492537313433,456,0.1701492537313433,2224,0.8298507462686567,19,0,0.0,5,0.2631578947368421,5,0.2631578947368421,14,0.7368421052631579
-87.626,41.885,768,0,0.0,0,0.0,0,0.0,768,1.0,7,0,0.0,0,0.0,0,0.0,7,1.0
-87.626,41.8855,160,0,0.0,46,0.2875,46,0.2875,114,0.7125,4,0,0.0,1,0.25,1,0.25,3,0.75
-87.6255,41.8745,75,0,0.0,75,1.0,75,1.0,0,0.0,2,0,0.0,2,1.0,2,1.0,0,0.0
-87.6255,41.875,62,0,0.0,62,1.0,62,1.0,0,0.0,3,0,0.0,3,1.0,3,1.0,0,0.0
-87.6255,41.8755,1974,245,0.12411347517730496,1266,0.6413373860182371,1511,0.7654508611955421,463,0.23454913880445796,51,5,0.09803921568627451,28,0.5490196078431373,33,0.6470588235294118,18,0.35294117647058826
-87.6255,41.876,198,70,0.35353535353535354,75,0.3787878787878788,145,0.7323232323232323,53,0.2676767676767677,9,3,0.3333333333333333,4,0.4444444444444444,7,0.7777777777777778,2,0.2222222222222222
-87.6255,41.8765,3442,1401,0.4070307960488088,1883,0.5470656595002905,3284,0.9540964555490994,158,0.04590354445090064,46,9,0.1956521739130435,24,0.5217391304347826,33,0.717391304347826,13,0.2826086956521739
-87.6255,41.877,2338,215,0.09195893926432848,1193,0.5102651839178786,1408,0.6022241231822071,930,0.397775876817793,40,5,0.125,24,0.6,29,0.725,11,0.275
-87.6255,41.8775,426,29,0.06807511737089202,389,0.9131455399061033,418,0.9812206572769953,8,0.018779342723004695,9,1,0.1111111111111111,7,0.7777777777777778,8,0.8888888888888888,1,0.1111111111111111
-87.6255,41.878,2245,59,0.026280623608017816,1867,0.8316258351893095,1926,0.8579064587973274,319,0.14209354120267262,43,2,0.046511627906976744,30,0.6976744186046512,32,0.7441860465116279,11,0.2558139534883721
-87.6255,41.8785,369,0,0.0,335,0.907859078590786,335,0.907859078590786,34,0.0921409214092141,10,0,0.0,9,0.9,9,0.9,1,0.1
-87.6255,41.879,1209,0,0.0,619,0.5119933829611248,619,0.5119933829611248,590,0.4880066170388751,15,0,0.0,9,0.6,9,0.6,6,0.4
-87.6255,41.8795,6265,0,0.0,5143,0.8209098164405427,5143,0.8209098164405427,1122,0.1790901835594573,105,0,0.0,82,0.780952380952381,82,0.780952380952381,23,0.21904761904761905
-87.6255,41.88,1544,0,0.0,1486,0.9624352331606217,1486,0.9624352331606217,58,0.03756476683937824,18,0,0.0,13,0.7222222222222222,13,0.7222222222222222,5,0.2777777777777778
-87.6255,41.8805,2241,0,0.0,1343,0.5992860330209728,1343,0.5992860330209728,898,0.4007139669790272,43,0,0.0,20,0.46511627906976744,20,0.46511627906976744,23,0.5348837209302325
-87.6255,41.881,526,16,0.030418250950570342,470,0.8935361216730038,486,0.9239543726235742,40,0.07604562737642585,20,1,0.05,12,0.6,13,0.65,7,0.35
-87.6255,41.8815,329,80,0.24316109422492402,139,0.42249240121580545,219,0.6656534954407295,110,0.3343465045592705,11,2,0.18181818181818182,6,0.5454545454545454,8,0.7272727272727273,3,0.2727272727272727
-87.6255,41.882,7773,329,0.04232600025730091,5074,0.6527724173420816,5403,0.6950984175993825,2370,0.30490158240061754,95,4,0.042105263157894736,53,0.5578947368421052,57,0.6,38,0.4
-87.6255,41.8825,75,0,0.0,75,1.0,75,1.0,0,0.0,1,0,0.0,1,1.0,1,1.0,0,0.0
-87.6255,41.883,1112,99,0.08902877697841727,833,0.7491007194244604,932,0.8381294964028777,180,0.1618705035971223,16,2,0.125,9,0.5625,11,0.6875,5,0.3125
-87.6255,41.8835,47,0,0.0,0,0.0,0,0.0,47,1.0,1,0,0.0,0,0.0,0,0.0,1,1.0
-87.6255,41.884,6542,0,0.0,352,0.053806175481504126,352,0.053806175481504126,6190,0.9461938245184959,56,0,0.0,14,0.25,14,0.25,42,0.75
-87.6255,41.8845,1724,0,0.0,151,0.08758700696055685,151,0.08758700696055685,1573,0.9124129930394431,16,0,0.0,3,0.1875,3,0.1875,13,0.8125
-87.6255,41.885,3,0,0.0,0,0.0,0,0.0,3,1.0,1,0,0.0,0,0.0,0,0.0,1,1.0
-87.6255,41.8855,124,0,0.0,0,0.0,0,0.0,124,1.0,3,0,0.0,0,0.0,0,0.0,3,1.0
-87.625,41.8755,3737,76,0.020337168852020335,3190,0.8536259031308536,3266,0.8739630719828739,471,0.12603692801712604,63,3,0.047619047619047616,38,0.6031746031746031,41,0.6507936507936508,22,0.3492063492063492
-87.625,41.8765,1070,64,0.059813084112149535,893,0.8345794392523365,957,0.894392523364486,113,0.10560747663551402,19,2,0.10526315789473684,14,0.7368421052631579,16,0.8421052631578947,3,0.15789473684210525
-87.625,41.877,385,131,0.34025974025974026,163,0.42337662337662335,294,0.7636363636363637,91,0.23636363636363636,6,2,0.3333333333333333,2,0.3333333333333333,4,0.6666666666666666,2,0.3333333333333333
-87.625,41.8775,21,0,0.0,17,0.8095238095238095,17,0.8095238095238095,4,0.19047619047619047,3,0,0.0,2,0.6666666666666666,2,0.6666666666666666,1,0.3333333333333333
-87.625,41.878,2170,83,0.03824884792626728,1694,0.7806451612903226,1777,0.8188940092165898,393,0.18110599078341014,40,2,0.05,26,0.65,28,0.7,12,0.3
-87.625,41.8785,2,0,0.0,2,1.0,2,1.0,0,0.0,1,0,0.0,1,1.0,1,1.0,0,0.0
-87.625,41.879,111,0,0.0,111,1.0,111,1.0,0,0.0,4,0,0.0,4,1.0,4,1.0,0,0.0
-87.625,41.8795,1499,0,0.0,1152,0.7685123415610406,1152,0.7685123415610406,347,0.2314876584389593,47,0,0.0,32,0.6808510638297872,32,0.6808510638297872,15,0.3191489361702128
-87.625,41.8805,2682,0,0.0,1338,0.4988814317673378,1338,0.4988814317673378,1344,0.5011185682326622,36,0,0.0,17,0.4722222222222222,17,0.4722222222222222,19,0.5277777777777778
-87.625,41.881,115,0,0.0,112,0.9739130434782609,112,0.9739130434782609,3,0.02608695652173913,4,0,0.0,3,0.75,3,0.75,1,0.25
-87.625,41.8815,2,0,0.0,2,1.0,2,1.0,0,0.0,1,0,0.0,1,1.0,1,1.0,0,0.0
-87.625,41.882,2179,249,0.11427260211106012,1203,0.552088113813676,1452,0.6663607159247361,727,0.3336392840752639,42,4,0.09523809523809523,23,0.5476190476190477,27,0.6428571428571429,15,0.35714285714285715
-87.625,41.883,2250,108,0.048,1245,0.5533333333333333,1353,0.6013333333333334,897,0.39866666666666667,26,2,0.07692307692307693,15,0.5769230769230769,17,0.6538461538461539,9,0.34615384615384615
-87.625,41.884,1937,0,0.0,210,0.10841507485802789,210,0.10841507485802789,1727,0.8915849251419721,26,0,0.0,9,0.34615384615384615,9,0.34615384615384615,17,0.6538461538461539
-87.625,41.8845,128,0,0.0,16,0.125,16,0.125,112,0.875,5,0,0.0,1,0.2,1,0.2,4,0.8
-87.625,41.8855,903,0,0.0,0,0.0,0,0.0,903,1.0,2,0,0.0,0,0.0,0,0.0,2,1.0
-87.6245,41.8755,7276,58,0.007971412864211104,6785,0.932517866959868,6843,0.9404892798240791,433,0.059510720175920837,93,3,0.03225806451612903,66,0.7096774193548387,69,0.7419354838709677,24,0.25806451612903225
-87.6245,41.8765,965,114,0.11813471502590674,738,0.7647668393782383,852,0.8829015544041451,113,0.11709844559585492,20,2,0.1,15,0.75,17,0.85,3,0.15
-87.6245,41.877,1359,42,0.03090507726269316,1178,0.8668138337012509,1220,0.8977189109639441,139,0.10228108903605593,11,2,0.18181818181818182,4,0.36363636363636365,6,0.5454545454545454,5,0.45454545454545453
-87.6245,41.878,14302,95,0.006642427632498951,11205,0.7834568591805342,11300,0.7900992868130332,3002,0.20990071318696685,128,2,0.015625,100,0.78125,102,0.796875,26,0.203125
-87.6245,41.8785,264,0,0.0,45,0.17045454545454544,45,0.17045454545454544,219,0.8295454545454546,4,0,0.0,3,0.75,3,0.75,1,0.25
-87.6245,41.879,142,0,0.0,139,0.9788732394366197,139,0.9788732394366197,3,0.02112676056338028,4,0,0.0,3,0.75,3,0.75,1,0.25
-87.6245,41.8795,3134,147,0.04690491384811742,2562,0.8174856413529037,2709,0.8643905552010211,425,0.13560944479897893,40,1,0.025,26,0.65,27,0.675,13,0.325
-87.6245,41.88,720,43,0.059722222222222225,658,0.9138888888888889,701,0.9736111111111111,19,0.02638888888888889,13,1,0.07692307692307693,10,0.7692307692307693,11,0.8461538461538461,2,0.15384615384615385
-87.6245,41.8805,12815,223,0.01740148263753414,7664,0.5980491611392899,7887,0.615450643776824,4928,0.384549356223176,119,3,0.025210084033613446,64,0.5378151260504201,67,0.5630252100840336,52,0.4369747899159664
-87.6245,41.881,179,0,0.0,179,1.0,179,1.0,0,0.0,2,0,0.0,2,1.0,2,1.0,0,0.0
-87.6245,41.8815,128,0,0.0,128,1.0,128,1.0,0,0.0,1,0,0.0,1,1.0,1,1.0,0,0.0
-87.6245,41.882,3645,256,0.07023319615912209,1362,0.3736625514403292,1618,0.44389574759945133,2027,0.5561042524005487,54,4,0.07407407407407407,19,0.35185185185185186,23,0.42592592592592593,31,0.5740740740740741
-87.6245,41.8825,797,0,0.0,51,0.06398996235884567,51,0.06398996235884567,746,0.9360100376411543,11,0,0.0,1,0.09090909090909091,1,0.09090909090909091,10,0.9090909090909091
-87.6245,41.883,4854,134,0.027606098063452822,1860,0.3831891223733004,1994,0.4107952204367532,2860,0.5892047795632468,70,2,0.02857142857142857,35,0.5,37,0.5285714285714286,33,0.4714285714285714
-87.6245,41.8835,131,0,0.0,0,0.0,0,0.0,131,1.0,1,0,0.0,0,0.0,0,0.0,1,1.0
-87.6245,41.884,2623,0,0.0,693,0.26420129622569577,693,0.26420129622569577,1930,0.7357987037743042,59,0,0.0,29,0.4915254237288136,29,0.4915254237288136,30,0.5084745762711864
-87.6245,41.8845,475,0,0.0,0,0.0,0,0.0,475,1.0,10,0,0.0,0,0.0,0,0.0,10,1.0
-87.6245,41.885,499,0,0.0,0,0.0,0,0.0,499,1.0,7,0,0.0,0,0.0,0,0.0,7,1.0
-87.6245,41.8855,1929,0,0.0,195,0.10108864696734059,195,0.10108864696734059,1734,0.8989113530326595,13,0,0.0,5,0.38461538461538464,5,0.38461538461538464,8,0.6153846153846154
-87.6245,41.886,254,0,0.0,24,0.09448818897637795,24,0.09448818897637795,230,0.905511811023622,6,0,0.0,2,0.3333333333333333,2,0.3333333333333333,4,0.6666666666666666
-87.624,41.8745,2288,75,0.03277972027972028,1939,0.847465034965035,2014,0.8802447552447553,274,0.11975524475524475,41,2,0.04878048780487805,33,0.8048780487804879,35,0.8536585365853658,6,0.14634146341463414
-87.624,41.875,2857,130,0.04550227511375569,1852,0.648232411620581,1982,0.6937346867343367,875,0.3062653132656633,51,1,0.0196078431372549,45,0.8823529411764706,46,0.9019607843137255,5,0.09803921568627451
-87.624,41.8755,4086,45,0.011013215859030838,3386,0.8286833088595204,3431,0.8396965247185512,655,0.16030347528144884,110,2,0.01818181818181818,79,0.7181818181818181,81,0.7363636363636363,29,0.2636363636363636
-87.624,41.876,999,0,0.0,793,0.7937937937937938,793,0.7937937937937938,206,0.2062062062062062,31,0,0.0,22,0.7096774193548387,22,0.7096774193548387,9,0.2903225806451613
-87.624,41.8765,4190,200,0.0477326968973747,2427,0.579236276849642,2627,0.6269689737470167,1563,0.3730310262529833,65,4,0.06153846153846154,48,0.7384615384615385,52,0.8,13,0.2
-87.624,41.877,3063,117,0.03819784524975514,2333,0.7616715638263141,2450,0.7998694090760692,613,0.2001305909239308,57,3,0.05263157894736842,39,0.6842105263157895,42,0.7368421052631579,15,0.2631578947368421
-87.624,41.8775,1895,132,0.06965699208443271,1311,0.691820580474934,1443,0.7614775725593668,452,0.23852242744063323,43,4,0.09302325581395349,26,0.6046511627906976,30,0.6976744186046512,13,0.3023255813953488
-87.624,41.878,11755,609,0.05180774138664398,8106,0.6895789025946406,8715,0.7413866439812846,3040,0.25861335601871543,114,8,0.07017543859649122,73,0.6403508771929824,81,0.7105263157894737,33,0.2894736842105263
-87.624,41.8785,5832,239,0.04098079561042524,4485,0.7690329218106996,4724,0.8100137174211248,1108,0.18998628257887518,98,3,0.030612244897959183,72,0.7346938775510204,75,0.7653061224489796,23,0.23469387755102042
-87.624,41.879,13623,72,0.005285179475886369,10718,0.7867576892020847,10790,0.792042868677971,2833,0.20795713132202892,198,1,0.005050505050505051,147,0.7424242424242424,148,0.7474747474747475,50,0.25252525252525254
-87.624,41.8795,8484,680,0.08015087223008015,6443,0.7594295143800094,7123,0.8395803866100895,1361,0.16041961338991043,115,5,0.043478260869565216,80,0.6956521739130435,85,0.7391304347826086,30,0.2608695652173913
-87.624,41.88,10225,57,0.005574572127139364,9107,0.8906601466992665,9164,0.8962347188264059,1061,0.10376528117359413,118,3,0.025423728813559324,90,0.7627118644067796,93,0.788135593220339,25,0.211864406779661
-87.624,41.8805,13413,717,0.05345560277342876,9469,0.70595690747782,10186,0.7594125102512488,3227,0.24058748974875122,155,7,0.04516129032258064,96,0.6193548387096774,103,0.6645161290322581,52,0.33548387096774196
-87.624,41.881,8108,3038,0.37469166255550074,4040,0.49827331031080413,7078,0.8729649728663049,1030,0.1270350271336951,72,6,0.08333333333333333,48,0.6666666666666666,54,0.75,18,0.25
-87.624,41.8815,9506,527,0.05543867031348622,6839,0.719440353460972,7366,0.7748790237744583,2140,0.22512097622554175,55,4,0.07272727272727272,39,0.7090909090909091,43,0.7818181818181819,12,0.21818181818181817
-87.624,41.882,3694,601,0.16269626421223607,2593,0.7019491066594478,3194,0.8646453708716838,500,0.1353546291283162,50,4,0.08,35,0.7,39,0.78,11,0.22
-87.624,41.8825,7179,0,0.0,6776,0.9438640479175373,6776,0.9438640479175373,403,0.05613595208246274,100,0,0.0,84,0.84,84,0.84,16,0.16
-87.624,41.883,7576,0,0.0,6734,0.8888595564941922,6734,0.8888595564941922,842,0.11114044350580782,105,0,0.0,82,0.780952380952381,82,0.780952380952381,23,0.21904761904761905
-87.624,41.8835,4087,0,0.0,2636,0.644971862001468,2636,0.644971862001468,1451,0.35502813799853195,72,0,0.0,53,0.7361111111111112,53,0.7361111111111112,19,0.2638888888888889
-87.624,41.884,10506,0,0.0,3281,0.3122977346278317,3281,0.3122977346278317,7225,0.6877022653721683,142,0,0.0,102,0.7183098591549296,102,0.7183098591549296,40,0.28169014084507044
-87.624,41.8845,471,0,0.0,0,0.0,0,0.0,471,1.0,2,0,0.0,0,0.0,0,0.0,2,1.0
-87.624,41.885,714,0,0.0,0,0.0,0,0.0,714,1.0,6,0,0.0,0,0.0,0,0.0,6,1.0
-87.624,41.8855,420,0,0.0,137,0.3261904761904762,137,0.3261904761904762,283,0.6738095238095239,11,0,0.0,2,0.18181818181818182,2,0.18181818181818182,9,0.8181818181818182
-87.624,41.886,646,0,0.0,0,0.0,0,0.0,646,1.0,9,0,0.0,0,0.0,0,0.0,9,1.0
-87.6235,41.8745,553,68,0.12296564195298372,424,0.7667269439421338,492,0.8896925858951176,61,0.11030741410488246,17,1,0.058823529411764705,14,0.8235294117647058,15,0.8823529411764706,2,0.11764705882352941
-87.6235,41.875,115,3,0.02608695652173913,94,0.8173913043478261,97,0.8434782608695652,18,0.1565217391304348,10,1,0.1,8,0.8,9,0.9,1,0.1
-87.6235,41.8755,1583,0,0.0,1230,0.7770056854074542,1230,0.7770056854074542,353,0.2229943145925458,35,0,0.0,28,0.8,28,0.8,7,0.2
-87.6235,41.876,472,55,0.11652542372881355,341,0.722457627118644,396,0.8389830508474576,76,0.16101694915254236,30,4,0.13333333333333333,20,0.6666666666666666,24,0.8,6,0.2
-87.6235,41.8765,16386,1674,0.10216038081288906,11629,0.7096911998047113,13303,0.8118515806176003,3083,0.18814841938239962,90,10,0.1111111111111111,63,0.7,73,0.8111111111111111,17,0.18888888888888888
-87.6235,41.878,6871,219,0.03187308979770048,5007,0.7287148886624946,5226,0.760587978460195,1645,0.23941202153980498,53,4,0.07547169811320754,25,0.4716981132075472,29,0.5471698113207547,24,0.4528301886792453
-87.6235,41.8805,2265,480,0.2119205298013245,353,0.15584988962472407,833,0.3677704194260486,1432,0.6322295805739514,41,9,0.21951219512195122,12,0.2926829268292683,21,0.5121951219512195,20,0.4878048780487805
-87.6235,41.884,394,0,0.0,85,0.21573604060913706,85,0.21573604060913706,309,0.7842639593908629,10,0,0.0,3,0.3,3,0.3,7,0.7
-87.623,41.875,3597,147,0.0408673894912427,3328,0.9252154573255491,3475,0.9660828468167918,122,0.03391715318320823,31,2,0.06451612903225806,24,0.7741935483870968,26,0.8387096774193549,5,0.16129032258064516
-87.623,41.8755,5650,287,0.05079646017699115,3952,0.6994690265486726,4239,0.7502654867256637,1411,0.2497345132743363,113,8,0.07079646017699115,77,0.6814159292035398,85,0.7522123893805309,28,0.24778761061946902
-87.623,41.876,1466,193,0.13165075034106413,1016,0.6930422919508867,1209,0.8246930422919508,257,0.1753069577080491,52,4,0.07692307692307693,37,0.7115384615384616,41,0.7884615384615384,11,0.21153846153846154
-87.623,41.878,973,142,0.1459403905447071,386,0.39671120246659813,528,0.5426515930113052,445,0.4573484069886948,40,6,0.15,14,0.35,20,0.5,20,0.5
-87.623,41.8805,975,261,0.2676923076923077,272,0.27897435897435896,533,0.5466666666666666,442,0.4533333333333333,27,7,0.25925925925925924,9,0.3333333333333333,16,0.5925925925925926,11,0.4074074074074074
-87.623,41.884,335,0,0.0,12,0.03582089552238806,12,0.03582089552238806,323,0.9641791044776119,8,0,0.0,1,0.125,1,0.125,7,0.875
